pea	pease
hake	hakes
professional	professionals
undersecretary	undersecretaries
debater	debaters
nativist	nativists
heir	heirs
darter	darters
coyote	coyotes
beech	beeches
gatecrasher	gatecrashers
bureaucrat	bureaucrats
masseur	masseurs
draper	drapers
ayatollah	ayatollahs
firefly	fireflies
abettor	abettors
front-runner	front-runners
hunter	hunters
medium	mediums
turkey	turkeys
monarch	monarchs
newcomer	newcomers
bluebird	bluebirds
commentator	commentators
ichthyologist	ichthyologists
middleweight	middleweights
fundamentalist	fundamentalists
bondholder	bondholders
brigadier	brigadiers
proselyte	proselytes
canvasser	canvassers
savior	saviors
silverback	silverbacks
oviraptorid	oviraptorids
photographer	photographers
robber	robbers
sentimentalist	sentimentalists
kob	kobs
believer	believers
loggerhead	loggerheads
skateboarder	skateboarders
diamondback	diamondbacks
porcupine	porcupines
fisherman	fishermens
ward	wards
toddler	toddlers
bollworm	bollworms
suspect	suspects
automaton	automatons
stylite	stylites
ganger	gangers
lamprey	lampreys
inductee	inductees
stoat	stoats
clansman	clansmen
cockerel	cockerels
wasp	wasps
follower	followers
kingpin	kingpins
shiner	shiners
courser	coursers
kookaburra	kookaburras
sir	sirs
papyrus	papyri
bryozoan	bryozoans
crustacean	crustaceans
dressmaker	dressmakers
pinto	pintos
skipper	skippers
bookworm	bookworms
commodore	commodores
caiman	caimans
lycaenid	lycaenids
annihilator	annihilators
combatant	combatants
reveler	revelers
hater	haters
phrenologist	phrenologists
bibliophile	bibliophiles
mulatto	mulattoes
relict	relicts
mafioso	mafiosos
coneflower	coneflowers
anaconda	anacondas
weatherman	weathermen
galago	galagos
lily	lilys
muralist	muralists
underwing	underwings
hummer	hummers
polygamist	polygamists
aspen	aspens
parasite	parasites
heron	herons
blackberry	blackberries
builder	builders
cranberry	cranberries
puffball	puffballs
meerkat	meerkats
leader	leaders
renter	renters
eel	eels
brother-in-law	brothers-in-law
ordinary	ordinaries
vulgarian	vulgarians
investor	investors
sangoma	sangomas
leopard	leopards
rectifier	rectifiers
referral	referrals
upstart	upstarts
bondsman	bondsmen
postdoc	postdocs
landgrave	landgraves
colleague	colleagues
dairyman	dairymen
mastiff	mastiffs
itinerant	itinerants
ham	hams
marten	martens
dieter	dieters
mallard	mallards
moth	moths
authoritarian	authoritarians
hoarder	hoarders
slug	slugs
violet	violets
athlete	athletes
pony	ponys
tragedian	tragedians
narcissist	narcissists
starlet	starlets
hellhound	hellhounds
pickpocket	pickpockets
conservator	conservators
militarist	militarists
sapling	saplings
fly	flies
inventor	inventors
familiar	familiars
pup	pups
rigger	riggers
springbok	springboks
fetishist	fetishists
demographer	demographers
fool	fools
harvester	harvesters
mongoose	mongooses
astronomer	astronomers
neurologist	neurologists
casualty	casualties
prefect	prefects
soprano	sopranos
broom	brooms
roommate	roommates
coral	corals
gunman	gunmen
whitefly	whiteflies
grader	graders
freeman	freemen
farmer	farmers
light	lights
copper	coppers
mentor	mentors
tarantula	tarantulas
panderer	panderers
tout	touts
kinglet	kinglets
deputy	deputies
auk	auks
golfer	golfers
mushroom	mushrooms
newsagent	newsagents
lemon	lemons
avocado	avocados
indigo	indigos
plowman	ploughmen
subject	subjects
alder	alders
collector	collectors
loser	losers
poke	pokes
buttercup	buttercups
opossum	opossums
mahatma	mahatmas
cosmetologist	cosmetologists
banker	bankers
foxhound	foxhounds
overseer	overseers
wren	wrens
pipit	pipits
mole	moles
bettor	bettors
capuchin	capuchins
relative	relatives
kitty	kitties
seeker	seekers
wanderer	wanderers
tourist	tourists
bracero	braceros
pussycat	pussycats
prince	princes
patriot	patriots
jacamar	jacamars
snapper	snappers
twin	twins
blue	blues
proconsul	proconsuls
shadow	shadows
voice	voices
tragopan	tragopans
fish	fishes
scorekeeper	scorekeepers
bride	brides
maker	makers
bigot	bigots
monkey	monkeys
crane	cranes
mate	mates
macaque	macaques
hood	hoods
hoopoe	hoopoes
antbird	antbirds
orthodontist	orthodontists
recruiter	recruiters
pyromaniac	pyromaniacs
lentil	lentils
angler	anglers
honeypot	honeypots
narwhal	narwhals
greeter	greeters
biologist	biologists
handyman	handymen
letterman	lettermen
tamandua	tamanduas
curlew	curlews
stevedore	stevedores
seal	seals
ass	asses
saver	savers
weeper	weepers
currant	currants
scratcher	scratchers
filer	filers
evergreen	evergreens
respondent	respondents
mezzo-soprano	mezzo-sopranos
ant	ants
gaucho	gauchos
citizen	citizens
bovid	bovids
miser	misers
acquirer	acquirers
leviathan	leviathans
tadpole	tadpoles
papist	papists
hawk	hawks
ignoramus	ignoramuses
undergraduate	undergraduates
swinger	swingers
cultist	cultists
malcontent	malcontents
whip	whips
orange	oranges
hajji	hajjis
sissy	sissies
beast	beasts
mullet	mullets
underachiever	underachievers
genealogist	genealogists
swimmer	swimmers
idol	idols
reliever	relievers
dwarf	dwarfs
trainee	trainees
rani	ranis
world	worlds
heavyweight	heavyweights
wagtail	wagtails
narc	narcs
sphinx	sphinxes
greenskeeper	greenskeepers
marmoset	marmosets
great	greats
potter	potters
clarinetist	clarinetists
employer	employers
worrier	worriers
conversationalist	conversationalists
namer	namers
ray	rays
mayfly	mayflies
mammal	mammals
kibitzer	kibitzers
gutter	gutters
cipher	ciphers
tulip	tulips
pterodactyl	pterodactyls
demonstrator	demonstrators
monolingual	monolinguals
spammer	spammers
swallow	swallows
nuncio	nuncios
fastener	fasteners
satyr	satyrs
representative	representatives
cultivar	cultivars
pomelo	pomelos
adoptee	adoptees
broker-dealer	broker-dealers
soprano	soprani
viticulturist	viticulturists
presenter	presenters
tangerine	tangerines
satirist	satirists
guarantor	guarantors
taxidermist	taxidermists
striper	stripers
modifier	modifiers
courtier	courtiers
physicist	physicists
consignee	consignees
steeplechaser	steeplechasers
lemur	lemurs
qualifier	qualifiers
dermatologist	dermatologists
haricot	haricots
lawgiver	lawgivers
outpatient	outpatients
matriarch	matriarchs
quail	quails
shearwater	shearwaters
hope	hopes
legatee	legatees
beef	beefs
windowpane	windowpanes
examiner	examiners
vigilante	vigilantes
cyprinid	cyprinids
morel	morels
butcher	butchers
pilchard	pilchards
sage	sages
switcher	switchers
housemate	housemates
ruler	rulers
gaffer	gaffers
beneficiary	beneficiaries
castrato	castrati
scofflaw	scofflaws
chaplain	chaplains
pill	pills
meteorologist	meteorologists
barnstormer	barnstormers
songbird	songbirds
accuser	accusers
hotdog	hotdogs
scoter	scoters
schoolboy	schoolboys
scalper	scalpers
liverwort	liverworts
filly	fillies
adolescent	adolescents
wallaby	wallabies
bitterroot	bitterroots
giver	givers
butterfly	butterflies
shrimp	shrimps
philosopher	philosophers
orchestrator	orchestrators
moll	molls
beetroot	beetroots
exorcist	exorcists
colonel	colonels
oleander	oleanders
carpetbagger	carpetbaggers
groupie	groupies
wether	wethers
cycad	cycads
cofounder	cofounders
cenobite	cenobites
abolitionist	abolitionists
banyan	banyans
palatine	palatines
globetrotter	globetrotters
apricot	apricots
rustic	rustics
embryo	embryos
mestizo	mestizos
carabao	carabaos
oppressor	oppressors
molester	molesters
headmistress	headmistresses
liquidator	liquidators
officeholder	officeholders
okapi	okapis
married	marrieds
hollyhock	hollyhocks
pomegranate	pomegranates
beagle	beagles
ostrich	ostriches
creep	creeps
mandrill	mandrills
vegetarian	vegetarians
primate	primates
paralegal	paralegals
legionnaire	legionnaires
spy	spiess
princess	princesses
patrician	patricians
detective	detectives
innocent	innocents
mamba	mambas
anesthesiologist	anesthesiologists
archduke	archdukes
elephant	elephants
hero	heros
alcalde	alcaldes
asp	asps
airhead	airheads
honeycreeper	honeycreepers
mackerel	mackerels
hominoid	hominoids
remover	removers
sheik	sheiks
rotavirus	rotaviruses
brit	brits
falconer	falconers
hack	hacks
coot	coots
aspirant	aspirants
bear	bears
hound	hounds
taskmaster	taskmasters
wallflower	wallflowers
piglet	piglets
headhunter	headhunters
mustang	mustangs
chiropractor	chiropractors
hysteric	hysterics
tang	tangs
gainer	gainers
neurosurgeon	neurosurgeons
easterner	easterners
pitta	pittas
stockman	stockmen
trilobite	trilobites
boyfriend	boyfriends
wahoo	wahoos
slugger	sluggers
daughter-in-law	daughters-in-law
skater	skaters
vestryman	vestrymen
homeboy	homeboys
agouti	agoutis
watchmaker	watchmakers
thrift	thrifts
aunt	aunts
rust	rusts
ombudsman	ombudsmen
spouse	spouses
unfortunate	unfortunates
caster	casters
trombonist	trombonists
learner	learners
villain	villains
periwinkle	periwinkles
caterer	caterers
navigator	navigators
thane	thanes
policyholder	policyholders
scribe	scribes
cad	cads
bombardier	bombardiers
echidna	echidnas
dill	dills
lackey	lackeys
ferret	ferrets
lobbyist	lobbyists
medalist	medalists
optician	opticians
etymologist	etymologists
cabbage	cabbages
kumquat	kumquats
rat	rats
peach	peaches
oat	oats
sorceress	sorceresses
hawk	hawkses
eater	eaters
yogi	yogis
albino	albinos
admirer	admirers
convert	converts
ecologist	ecologists
edger	edgers
regent	regents
stamper	stampers
raver	ravers
tramp	tramps
augur	augurs
bolete	boletes
prawn	prawns
lady-in-waiting	ladies-in-waiting
coroner	coroners
consul	consuls
sun	suns
tipster	tipsters
clergyman	clergymen
seller	sellers
signalman	signalmen
elm	elms
dishwasher	dishwashers
humanist	humanists
candidate	candidates
bracken	brackens
marquess	marquesses
palomino	palominos
shaman	shamen
ironworker	ironworkers
licensee	licensees
hyacinth	hyacinths
blackwood	blackwoods
larch	larches
hypnotist	hypnotists
stargazer	stargazers
myna	mynas
abbot	abbots
redneck	rednecks
man	mans
vandal	vandals
robin	robins
arachnid	arachnids
doorkeeper	doorkeepers
insomniac	insomniacs
pawpaw	pawpaws
gull	gulls
godfather	godfathers
cuckoo	cuckoos
broadbill	broadbills
vintner	vintners
nabob	nabobs
prospector	prospectors
cock	cocks
companion	companions
regular	regulars
imposter	imposters
crop	crops
sheriff	sheriffs
saxophonist	saxophonists
shipbuilder	shipbuilders
saguaro	saguaros
neighbor	neighbors
orchid	orchids
intellectual	intellectuals
announcer	announcers
anthropologist	anthropologists
confidante	confidantes
chit	chits
comedienne	comediennes
begum	begums
legate	legates
sleeper	sleepers
rue	ruess
pear	pearses
case	cases
sorcerer	sorcerers
palm	palms
baron	barons
notary	notaries
eyewitness	eyewitnesses
kudu	kudus
commissar	commissars
bulbul	bulbuls
ethologist	ethologists
careerist	careerists
thrush	thrushes
falangist	falangists
hatemonger	hatemongers
baritone	baritones
rogue	rogues
asthmatic	asthmatics
pistachio	pistachios
drafter	drafters
material	materials
larva	larvae
colleen	colleens
daredevil	daredevils
jester	jesters
rodent	rodents
game	games
anomaly	anomalies
begonia	begonias
quarryman	quarrymen
philanthropist	philanthropists
mare	mares
seagrass	seagrasses
vertebrate	vertebrates
helmsman	helmsmen
teacher	teachers
journalist	journalists
plum	plums
fusilier	fusiliers
hostage	hostages
advocate	advocates
torchbearer	torchbearers
toastmaster	toastmasters
grouch	grouches
loner	loners
crooner	crooners
planter	planters
negotiator	negotiators
drill	drills
vassal	vassals
bishop	bishops
slammer	slammers
peacekeeper	peacekeepers
dynast	dynasts
gadfly	gadflies
snowboarder	snowboarders
hag	hags
poon	poons
buzzard	buzzards
angel	angels
cornerback	cornerbacks
liberal	liberals
clam	clams
runner	runners
migrant	migrants
upholsterer	upholsterers
viroid	viroids
native	natives
user	users
homosexual	homosexuals
paleontologist	paleontologists
countertenor	countertenors
mycologist	mycologists
stork	storks
romanticist	romanticists
drake	drakes
technocrat	technocrats
hangman	hangmen
salvager	salvagers
pointer	pointers
dragonfly	dragonflies
thinker	thinkers
isopod	isopods
publicist	publicists
superintendent	superintendents
buddy	buddies
introvert	introverts
meadowlark	meadowlarks
plover	plovers
rocket	rockets
shopkeeper	shopkeepers
fungus	funguses
foreigner	foreigners
copepod	copepods
submariner	submariners
thistle	thistles
stock	stocks
connoisseur	connoisseurs
troublemaker	troublemakers
novelist	novelists
buckskin	buckskins
occultist	occultists
spokesperson	spokespersons
schoolgirl	schoolgirls
dandy	dandies
dicynodont	dicynodonts
patentee	patentees
helpmate	helpmates
gorilla	gorillas
cleric	clerics
retiree	retirees
bandicoot	bandicoots
senator	senators
friar	friars
gladiator	gladiators
gecko	geckos
personality	personalities
radish	radishes
wrasse	wrasses
skirmisher	skirmishers
syndic	syndics
pelican	pelicans
generator	generators
rhymer	rhymers
mariposa	mariposas
hunter-gatherer	hunter-gatherers
entertainer	entertainers
sneak	sneaks
instar	instars
stepparent	stepparents
stroke	strokes
celebrity	celebrities
characin	characins
pinscher	pinschers
balancer	balancers
goalkeeper	goalkeepers
heathen	heathens
narrator	narrators
woodcutter	woodcutters
blond	blonds
fly	flys
canine	canines
smelt	smelts
roadrunner	roadrunners
ouster	ousters
nan	nans
selectman	selectmen
escort	escorts
tribune	tribunes
cockatoo	cockatoos
animator	animators
forefather	forefathers
ideal	ideals
seer	seers
thyme	thymes
photojournalist	photojournalists
villager	villagers
ballplayer	ballplayers
praya	prayas
liveryman	liverymen
satellite	satellites
prey	preys
scriptwriter	scriptwriters
maenad	maenads
wolverine	wolverines
cherry	cherries
gangsta	gangstas
literate	literates
growler	growlers
reptile	reptiles
hen	henss
dicot	dicots
streaker	streakers
digger	diggers
stationer	stationers
numismatist	numismatists
federalist	federalists
plenipotentiary	plenipotentiaries
jackdaw	jackdaws
jobber	jobbers
dunce	dunces
consumer	consumers
import	imports
lascar	lascars
delinquent	delinquents
fan	fans
manipulator	manipulators
claimant	claimants
washer	washers
diviner	diviners
caltrop	caltrops
catcher	catchers
copywriter	copywriters
traveler	travelers
lumper	lumpers
nasturtium	nasturtiums
cheapskate	cheapskates
life	lifes
maharaja	maharajas
mercenary	mercenaries
foxglove	foxgloves
paparazzo	paparazzi
therapist	therapists
newscaster	newscasters
chub	chubs
mathematician	mathematicians
salesclerk	salesclerks
cashier	cashiers
leper	lepers
mango	mangoes
cat	cats
mistletoe	mistletoes
poacher	poachers
breeder	breeders
shipwright	shipwrights
ambassador	ambassadors
ranter	ranters
pest	pests
weasel	weasels
bramble	brambles
muskrat	muskrats
loon	loons
hotspur	hotspurs
bullfrog	bullfrogs
biographer	biographers
medium	media
songster	songsters
sipper	sippers
stallion	stallions
dreamer	dreamers
codger	codgers
curator	curators
anathema	anathemas
analyst	analysts
natural	naturals
politician	politicians
persimmon	persimmons
intervenor	intervenors
goner	goners
promoter	promoters
dinoflagellate	dinoflagellates
conch	conchs
confederate	confederates
kidnapper	kidnappers
miro	miros
quarterback	quarterbacks
mallow	mallows
hind	hinds
commissioner	commissioners
headliner	headliners
interviewer	interviewers
bookkeeper	bookkeepers
rover	rovers
hop	hops
redwing	redwings
ascidian	ascidians
squire	squires
hagiographer	hagiographers
distributor	distributors
animist	animists
compulsive	compulsives
ornithischian	ornithischians
agent	agents
absolutist	absolutists
onlooker	onlookers
recruit	recruits
pintail	pintails
flanker	flankers
pimp	pimps
laurel	laurels
spectator	spectators
signer	signers
ethnologist	ethnologists
bantamweight	bantamweights
alchemist	alchemists
bruin	bruins
starter	starters
archdeacon	archdeacons
cricket	crickets
peregrine	peregrines
idealist	idealists
yogi	yogin
beluga	belugas
apache	apaches
catfish	catfishes
lout	louts
tapeworm	tapeworms
martyr	martyrs
luminary	luminaries
tyrannosaur	tyrannosaurs
longhorn	longhorns
constructivist	constructivists
theologian	theologians
reciter	reciters
deaconess	deaconesses
trophozoite	trophozoites
destroyer	destroyers
columbine	columbines
damsel	damsels
changer	changers
nerd	nerds
magnolia	magnolias
sponge	sponges
argentine	argentines
oystercatcher	oystercatchers
hoodoo	hoodoos
upsetter	upsetters
hugger	huggers
wicket-keeper	wicket-keepers
redbud	redbuds
triumvir	triumvirs
supporter	supporters
appellant	appellants
hornet	hornets
logician	logicians
curassow	curassows
conformist	conformists
swift	swifts
sachem	sachems
heath	heaths
pinwheel	pinwheels
sabra	sabras
moray	morays
walnut	walnuts
violator	violators
immunologist	immunologists
clapper	clappers
pharisee	pharisees
missionary	missionaries
hyrax	hyraxes
gawker	gawkers
taxonomist	taxonomists
sedum	sedums
prowler	prowlers
apparatchik	apparatchiks
drone	drones
lichen	lichens
armyworm	armyworms
forebear	forebears
winner	winners
homo	homos
hippopotamus	hippopotami
clown	clowns
madame	mesdames
tomboy	tomboys
therapsid	therapsids
achiever	achievers
madam	madams
cod	cods
squaw	squaws
fundraiser	fundraisers
barker	barkers
matchmaker	matchmakers
countryman	countrymen
barracuda	barracudas
allocator	allocators
granddaughter	granddaughters
lilac	lilacs
left-hander	left-handers
ti	tis
infantryman	infantrymen
crake	crakes
harpist	harpists
constable	constables
cannibal	cannibals
mimic	mimics
embalmer	embalmers
glassmaker	glassmakers
venturer	venturers
alpaca	alpacas
beetle	beetles
cadet	cadets
tarsier	tarsiers
vireo	vireos
scarab	scarabs
walrus	walruses
honeybee	honeybees
ghostwriter	ghostwriters
captor	captors
boy	boies
totalitarian	totalitarians
boxer	boxers
luthier	luthiers
constituent	constituents
putter	putters
butler	butlers
melon	melons
bouncer	bouncers
loudmouth	loudmouths
vicar	vicars
brahman	brahmans
vaquero	vaqueros
mew	mews
samurai	samurais
camper	campers
eft	efts
waif	waives
pharmacist	pharmacists
endocrinologist	endocrinologists
canna	cannas
painter	painters
setter	setters
dauphin	dauphins
salmon	salmons
stylist	stylists
primitive	primitives
warhorse	warhorses
livestock	livestocks
brave	braves
moviegoer	moviegoers
milkman	milkmen
strongman	strongmen
drunk	drunks
lather	lathers
study	studies
forger	forgers
renegade	renegades
blackberry	blackberrys
tackler	tacklers
gobbler	gobblers
terrapin	terrapins
neurotic	neurotics
plant	plants
organizer	organizers
libertine	libertines
copycat	copycats
miller	millers
pony	ponies
nutter	nutters
provost	provosts
toxicologist	toxicologists
shipper	shippers
herbivore	herbivores
pain	pains
partridge	partridges
tomatillo	tomatillos
cougar	cougars
pentathlete	pentathletes
serf	serfs
taxer	taxers
mangabey	mangabeys
strider	striders
son-in-law	sons-in-law
box	boxes
bungler	bunglers
entrepreneur	entrepreneurs
fingerling	fingerlings
hickory	hickories
successor	successors
girl	girls
tree	trees
scrubber	scrubbers
pornographer	pornographers
carrier	carriers
finalist	finalists
opposition	oppositions
quince	quinces
onion	onions
chela	chelae
eggplant	eggplants
breaker	breakers
scallop	scallops
roble	robles
piranha	piranhas
heckler	hecklers
crimp	crimps
termer	termers
swiftlet	swiftlets
cantor	cantors
model	models
polyp	polyps
sawyer	sawyers
snowball	snowballs
thrall	thralls
architect	architects
pervert	perverts
litigant	litigants
calculator	calculators
entrant	entrants
farmhand	farmhands
welder	welders
fare	fares
gopher	gophers
toast	toasts
cassowary	cassowaries
outdoorsman	outdoorsmen
dacoit	dacoits
copyist	copyists
storyteller	storytellers
occupier	occupiers
mulberry	mulberries
appropriator	appropriators
tick	ticks
alewife	alewives
burgomaster	burgomasters
trillium	trilliums
hauler	haulers
homunculus	homunculi
rhododendron	rhododendrons
confidant	confidants
royal	royals
goat	goats
beater	beaters
king	kings
coward	cowards
manatee	manatees
speedskater	speedskaters
sewer	sewers
nazi	nazis
sprinter	sprinters
master	masters
jawan	jawans
puritan	puritans
ornithologist	ornithologists
translator	translators
doyenne	doyennes
grammarian	grammarians
packer	packers
redeemer	redeemers
squatter	squatters
sailmaker	sailmakers
syndicator	syndicators
horticulturist	horticulturists
cub	cubs
nematode	nematodes
editor	editors
scion	scions
bibliographer	bibliographers
weightlifter	weightlifters
cantaloupe	cantaloupes
epicure	epicures
customer	customers
drinker	drinkers
rowan	rowans
grandparent	grandparents
conditioner	conditioners
interpreter	interpreters
slouch	slouches
godchild	godchildren
eccentric	eccentrics
protegee	protegees
ginkgo	ginkgos
tailor	tailors
diabetic	diabetics
telecaster	telecasters
nephew	nephews
trusty	trusties
picker	pickers
laborer	laborers
senior	seniors
arsonist	arsonists
disciple	disciples
busker	buskers
runner-up	runner-ups
nihilist	nihilists
bedfellow	bedfellows
crocodile	crocodiles
diver	divers
fellow	fellows
bushwhacker	bushwhackers
advertiser	advertisers
undesirable	undesirables
booker	bookers
personage	personages
pedophile	pedophiles
beachcomber	beachcombers
timekeeper	timekeepers
jilt	jilts
sharecropper	sharecroppers
landlord	landlords
ginger	gingers
bunt	bunts
fencer	fencers
weaver	weavers
locator	locators
colonial	colonials
parrot	parrots
hairdresser	hairdressers
buster	busters
trustee	trustees
lupine	lupines
salesman	salesmen
marathoner	marathoners
platypus	platypuses
facilitator	facilitators
prosimian	prosimians
dry	dries
shorebird	shorebirds
panhandler	panhandlers
saboteur	saboteurs
bennet	bennets
catechist	catechists
pine	pines
dalmatian	dalmatians
peddler	peddlers
modern	moderns
stocker	stockers
sheep	sheeps
aquatic	aquatics
plumber	plumbers
hanger	hangers
expert	experts
addict	addicts
bootmaker	bootmakers
ethnic	ethnics
procurator	procurators
caterpillar	caterpillars
proposer	proposers
picket	pickets
gal	gals
mariner	mariners
foot	feet
reprobate	reprobates
heretic	heretics
surgeon	surgeons
pluralist	pluralists
seedling	seedlings
hitchhiker	hitchhikers
boar	boars
minnow	minnows
infielder	infielders
artiste	artistes
boy	boys
pauper	paupers
spearhead	spearheads
cedar	cedars
supremo	supremos
valet	valets
salesperson	salespeople
attache	attaches
ass	assess
gastropod	gastropods
canoeist	canoeists
caretaker	caretakers
celebrant	celebrants
hippopotamus	hippopotamuses
caecilian	caecilians
eaglet	eaglets
inquisitor	inquisitors
projectionist	projectionists
bimbo	bimbos
anatomist	anatomists
filibuster	filibusters
jumper	jumpers
fanatic	fanatics
freeman	freemans
hybrid	hybrids
pike	pikes
changeling	changelings
triplet	triplets
registrar	registrars
grunt	grunts
depositor	depositors
stunt	stunts
flapper	flappers
broad	broads
executioner	executioners
poisoner	poisoners
veteran	veterans
cartwright	cartwrights
czar	czars
mosquito	mosquitoes
singer	singers
geoduck	geoducks
beatnik	beatniks
descender	descenders
beggar	beggars
geezer	geezers
iconoclast	iconoclasts
worm	worms
bandleader	bandleaders
chef	chefs
imp	imps
hammerhead	hammerheads
statistician	statisticians
teamster	teamsters
all-rounder	all-rounders
reviewer	reviewers
quack	quacks
oceanographer	oceanographers
dealer	dealers
liger	ligers
crewman	crewmen
noncombatant	noncombatants
bobcat	bobcats
octopus	octopuses
dame	dames
imperialist	imperialists
coauthor	coauthors
louse	lice
firstborn	firstborns
gillie	gillies
comedian	comedians
linden	lindens
escapist	escapists
ringer	ringers
sucker	suckers
biochemist	biochemists
homeopath	homeopaths
chancellor	chancellors
gamekeeper	gamekeepers
scrutineer	scrutineers
cartoonist	cartoonists
condor	condors
agriculturist	agriculturists
egomaniac	egomaniacs
gitano	gitanos
impersonator	impersonators
pansy	pansies
billionaire	billionaires
delegate	delegates
resident	residents
amphipod	amphipods
humpback	humpbacks
moralist	moralists
motorcyclist	motorcyclists
tosser	tossers
pursuer	pursuers
composite	composites
tier	tiers
surveyor	surveyors
domestic	domestics
shopaholic	shopaholics
sophomore	sophomores
accountant	accountants
hedgehog	hedgehogs
incurable	incurables
scad	scads
peri	peris
lacewing	lacewings
stickleback	sticklebacks
tigress	tigresses
osprey	ospreys
holly	hollies
spaniel	spaniels
boa	boas
oryx	oryxes
yearling	yearlings
vacationer	vacationers
defeatist	defeatists
evolutionist	evolutionists
daisy	daisies
grass	grasses
superbug	superbugs
groundnut	groundnuts
lilliputian	lilliputians
darling	darlings
gent	gents
heiress	heiresses
purveyor	purveyors
mink	minks
steelmaker	steelmakers
protist	protists
ethicist	ethicists
bargainer	bargainers
mango	mangos
witness	witnesses
surrealist	surrealists
man-at-arms	men-at-arms
spymaster	spymasters
ani	anis
stoic	stoics
fugitive	fugitives
dingo	dingos
clerk	clerks
parr	parrs
tanner	tanners
workmate	workmates
assistant	assistants
atheist	atheists
originator	originators
maestro	maestri
lightweight	lightweights
blogger	bloggers
reservist	reservists
bunny	bunnies
tamer	tamers
preserver	preservers
smoker	smokers
titmouse	titmice
transfer	transfers
moorhen	moorhens
malingerer	malingerers
puppeteer	puppeteers
puffer	puffers
grebe	grebes
bomber	bombers
brewer	brewers
contributor	contributors
cook	cooks
herald	heralds
pleaser	pleasers
islander	islanders
surfer	surfers
national	nationals
churchgoer	churchgoers
speaker	speakers
buck	bucks
hornbill	hornbills
terrorist	terrorists
hydrologist	hydrologists
artilleryman	artillerymen
gigolo	gigolos
sort	sorts
astrologer	astrologers
panelist	panelists
bombshell	bombshells
sojourner	sojourners
automaton	automata
botanist	botanists
psychic	psychics
bunkmate	bunkmates
hakim	hakims
forester	foresters
cheetah	cheetahs
marine	marines
hearer	hearers
wayfarer	wayfarers
stupid	stupids
thief	thieves
draftee	draftees
countess	countesses
cherub	cherubs
prebendary	prebendaries
caliph	caliphs
pheasant	pheasants
accomplice	accomplices
pusher	pushers
barbu	barbus
speculator	speculators
criminologist	criminologists
incumbent	incumbents
aquanaut	aquanauts
confessor	confessors
catch	catches
lory	lories
boarder	boarders
seahorse	seahorses
grabber	grabbers
liana	lianas
apple	apples
mantis	mantes
tagger	taggers
guesser	guessers
mouth	mouths
penguin	penguins
nitpicker	nitpickers
pivot	pivots
ideologist	ideologists
headmaster	headmasters
coachman	coachmen
bidder	bidders
kangaroo	kangaroos
cube	cubes
stakeholder	stakeholders
emigrant	emigrants
socialist	socialists
standard-bearer	standard-bearers
baronet	baronets
licenser	licensers
choreographer	choreographers
guzzler	guzzlers
cherub	cherubim
salp	salps
lesbian	lesbians
virtuoso	virtuosi
rotter	rotters
skinhead	skinheads
donor	donors
pompon	pompons
sod	sods
zebra	zebras
fortuneteller	fortunetellers
archer	archers
herring	herrings
supervisor	supervisors
cartographer	cartographers
plunderer	plunderers
starling	starlings
appointee	appointees
eavesdropper	eavesdroppers
frontiersman	frontiersmen
submitter	submitters
businesswoman	businesswomen
tailback	tailbacks
ivy	ivies
helminth	helminths
initiate	initiates
schmuck	schmucks
roller	rollers
possible	possibles
drunkard	drunkards
cameraman	cameramen
crackpot	crackpots
wearer	wearers
rival	rivals
collard	collards
kinsman	kinsmen
grain	grains
calabash	calabashes
tumbler	tumblers
maid	maids
bricklayer	bricklayers
malamute	malamutes
adventurer	adventurers
chapman	chapmans
cornflower	cornflowers
budgerigar	budgerigars
microorganism	microorganisms
sinner	sinners
pilot	pilots
crazy	crazies
groundling	groundlings
signaler	signalers
conductor	conductors
compiler	compilers
superior	superiors
creature	creatures
centipede	centipedes
brakeman	brakemen
bowerbird	bowerbirds
stewardess	stewardesses
leaseholder	leaseholders
romper	rompers
hurdler	hurdlers
admiral	admirals
jujube	jujubes
argonaut	argonauts
tern	terns
hatchling	hatchlings
scrambler	scramblers
hermit	hermits
bisexual	bisexuals
hazel	hazels
stag	stags
canon	canons
neoconservative	neoconservatives
exegete	exegetes
crinoid	crinoids
spotter	spotters
prankster	pranksters
advancer	advancers
shutterbug	shutterbugs
statesman	statesmen
dean	deans
victim	victims
coon	coons
mussel	mussels
squash	squashes
educator	educators
maestro	maestros
officiant	officiants
veterinarian	veterinarians
financier	financiers
birth	births
volunteer	volunteers
subshrub	subshrubs
bloodworm	bloodworms
psychologist	psychologists
curandero	curanderos
orderly	orderlies
yuppie	yuppies
stepfather	stepfathers
babbler	babblers
regicide	regicides
petitioner	petitioners
gofer	gofers
animal	animals
hellebore	hellebores
merino	merinos
schoolteacher	schoolteachers
pen	pens
cardoon	cardoons
decorator	decorators
rightist	rightists
sable	sables
sightseer	sightseers
wag	wags
corsair	corsairs
hand	hands
straggler	stragglers
lithographer	lithographers
sorrel	sorrels
stepson	stepsons
spider	spiders
pilgrim	pilgrims
stayer	stayers
hostess	hostesses
leaker	leakers
busboy	busboys
apologist	apologists
cyborg	cyborgs
basset	bassets
breadwinner	breadwinners
chandler	chandlers
adjudicator	adjudicators
cowpea	cowpeas
workaholic	workaholics
optimist	optimists
lizard	lizards
holdover	holdovers
oboist	oboists
sergeant	sergeants
crow	crows
playboy	playboys
polychaete	polychaetes
counselor	counselors
bull	bulls
cephalopod	cephalopods
nectarine	nectarines
coaster	coasters
planner	planners
regulator	regulators
mutineer	mutineers
bather	bathers
partner	partners
fascist	fascists
descendant	descendants
shocker	shockers
wiper	wipers
quahog	quahogs
archeologist	archeologists
bandit	bandits
cripple	cripples
bobby	bobbies
coati	coatis
empress	empresses
synapsid	synapsids
millet	millets
canary	canaries
prizefighter	prizefighters
rheumatologist	rheumatologists
purist	purists
sitter	sitters
viper	vipers
democrat	democrats
choker	chokers
wrecker	wreckers
extremist	extremists
saddler	saddlers
chump	chumps
jogger	joggers
nettle	nettles
postmaster	postmasters
televangelist	televangelists
freeholder	freeholders
tuna	tunas
scientist	scientists
broodmare	broodmares
romantic	romantics
vizier	viziers
receiver	receivers
artist	artists
latecomer	latecomers
tare	tares
petunia	petunias
understudy	understudies
ruff	ruffs
recipient	recipients
partygoer	partygoers
pronghorn	pronghorns
prosecutor	prosecutors
musician	musicians
raja	rajas
father	fathers
ripper	rippers
raiser	raisers
cottonwood	cottonwoods
aster	asters
pledge	pledges
cavalier	cavaliers
dispatcher	dispatchers
sadist	sadists
toiler	toilers
character	characters
turner	turners
gymnast	gymnasts
co-ed	co-eds
bug	bugs
sister	sisters
dove	doves
merganser	mergansers
internationalist	internationalists
gendarme	gendarmes
ocelot	ocelots
embroiderer	embroiderers
virologist	virologists
panther	panthers
young	youngs
comma	commas
marlin	marlins
rambler	ramblers
publisher	publishers
yeoman	yeomen
critic	critics
arbor	arbors
springer	springers
spy	spies
counter	counters
varmint	varmints
arbovirus	arboviruses
chicken	chickens
bullfighter	bullfighters
alarmist	alarmists
hotelier	hoteliers
sundew	sundews
watcher	watchers
hustler	hustlers
spendthrift	spendthrifts
supremacist	supremacists
leveler	levelers
scoutmaster	scoutmasters
speechwriter	speechwriters
importer	importers
climatologist	climatologists
bugle	bugles
yew	yews
fakir	fakirs
flamingo	flamingos
protea	proteas
inpatient	inpatients
iris	irises
marsupial	marsupials
titanosaur	titanosaurs
arrival	arrivals
fig	figs
cricketer	cricketers
namesake	namesakes
sweeper	sweepers
parapsychologist	parapsychologists
seeder	seeders
client	clients
abbe	abbes
ibis	ibises
preservationist	preservationists
splicer	splicers
abbess	abbesses
lister	listers
fence	fences
heavy	heavies
briber	bribers
woodpecker	woodpeckers
butternut	butternuts
monopolist	monopolists
marshal	marshals
goose	geese
informer	informers
cashew	cashews
stiff	stiffs
acolyte	acolytes
profiteer	profiteers
immortal	immortals
skullcap	skullcaps
armadillo	armadillos
sawfly	sawflies
bongo	bongos
compositor	compositors
seducer	seducers
siren	sirens
ensign	ensigns
abalone	abalones
scavenger	scavengers
collaborator	collaborators
butt	butts
liturgist	liturgists
survivor	survivors
wolfhound	wolfhounds
pea	peas
propagandist	propagandists
ascender	ascenders
bowhead	bowheads
nester	nesters
porgy	porgies
shrike	shrikes
cardiologist	cardiologists
orientalist	orientalists
popularizer	popularizers
screener	screeners
olm	olms
polluter	polluters
hart	harts
spoonbill	spoonbills
commando	commandoes
megalomaniac	megalomaniacs
cleaner	cleaners
beaver	beavers
roach	roaches
iceman	icemen
refugee	refugees
congregant	congregants
chink	chinks
guest	guests
enemy	enemies
bugler	buglers
kneeler	kneelers
prude	prudes
mute	mutes
blackbird	blackbirds
sycophant	sycophants
sorter	sorters
life	lives
overlord	overlords
tapper	tappers
usurer	usurers
terrier	terriers
framer	framers
rush	rushes
barmaid	barmaids
rail	rails
proxy	proxies
gannet	gannets
oncologist	oncologists
refiner	refiners
lawyer	lawyers
cypress	cypresses
guerrilla	guerrillas
dandelion	dandelions
defender	defenders
octogenarian	octogenarians
rapper	rappers
policeman	policemen
affiliate	affiliates
willet	willets
drudge	drudges
basil	basils
roughrider	roughriders
sender	senders
dick	dicks
caribou	caribous
tippler	tipplers
climber	climbers
parsnip	parsnips
shoveler	shovelers
plagiarist	plagiarists
widower	widowers
snob	snobs
homeowner	homeowners
prostitute	prostitutes
nonmember	nonmembers
cicada	cicadas
octopus	octopi
elk	elks
patriarch	patriarchs
bat	bats
radiologist	radiologists
housemaster	housemasters
arbitrageur	arbitrageurs
burgess	burgesses
greaser	greasers
frogmouth	frogmouths
playmaker	playmakers
loyalist	loyalists
mustard	mustards
fink	finks
petter	petters
gooseberry	gooseberries
herder	herders
woodsman	woodsmen
basilisk	basilisks
calypso	calypsos
sealer	sealers
spokeswoman	spokeswomen
freshman	freshmen
yucca	yuccas
god	gods
private	privates
spender	spenders
musicologist	musicologists
secessionist	secessionists
messiah	messiahs
tackle	tackles
nigger	niggers
bumblebee	bumblebees
hominid	hominids
adjuster	adjusters
rose	roses
echinoderm	echinoderms
grub	grubs
female	females
pallbearer	pallbearers
stitcher	stitchers
beekeeper	beekeepers
weed	weeds
revisionist	revisionists
belle	belles
warner	warners
walk-on	walk-ons
raspberry	raspberries
niece	nieces
oiler	oilers
webmaster	webmasters
half-breed	half-breeds
juvenile	juveniles
impressionist	impressionists
loader	loaders
snag	snags
insurgent	insurgents
bellwether	bellwethers
swan	swans
republican	republicans
waitress	waitresses
fluke	flukes
sierra	sierras
pagan	pagans
kiwi	kiwis
goral	gorals
streetwalker	streetwalkers
triton	tritons
upholder	upholders
sylph	sylphs
jewel	jewels
gametophyte	gametophytes
retrovirus	retroviruses
macadamia	macadamias
cowbird	cowbirds
groom	grooms
civilian	civilians
genius	genii
part-timer	part-timers
suffragette	suffragettes
chinchilla	chinchillas
zany	zanies
erotic	erotics
creeper	creepers
freak	freaks
whistler	whistlers
geologist	geologists
voyager	voyagers
patient	patients
torero	toreros
skylark	skylarks
teaser	teasers
viola	violas
embryologist	embryologists
bigamist	bigamists
schoolmate	schoolmates
groomsman	groomsmen
idler	idlers
polymath	polymaths
genet	genets
server	servers
dimwit	dimwits
naif	naifs
mater	maters
booster	boosters
foundress	foundresses
nightshade	nightshades
viscount	viscounts
subscriber	subscribers
spinster	spinsters
fisher	fishers
strawberry	strawberries
scorpion	scorpions
amputee	amputees
nonstarter	nonstarters
grosbeak	grosbeaks
butch	butches
blade	blades
guava	guavas
closer	closers
bilingual	bilinguals
invalid	invalids
trawler	trawlers
sheller	shellers
oblate	oblates
freedman	freedmen
eland	elands
pollard	pollards
kingmaker	kingmakers
cholla	chollas
dory	dories
lunatic	lunatics
hacker	hackers
searcher	searchers
townsman	townsmen
mourner	mourners
solitaire	solitaires
rapporteur	rapporteurs
associate	associates
saki	sakis
pedestrian	pedestrians
bookbinder	bookbinders
incompetent	incompetents
enthusiast	enthusiasts
newsreader	newsreaders
herpetologist	herpetologists
teal	teals
fledgling	fledglings
embodiment	embodiments
typist	typists
subordinate	subordinates
swami	swamis
snake	snakes
cockle	cockles
kleptomaniac	kleptomaniacs
badger	badgers
technophobe	technophobes
bilberry	bilberries
tail	tails
executor	executors
hitter	hitters
lector	lectors
conjurer	conjurers
cacique	caciques
spat	spats
territorial	territorials
gerbil	gerbils
quadruped	quadrupeds
camellia	camellias
quintuplet	quintuplets
baby	babys
motmot	motmots
shyster	shysters
bard	bards
bacillus	bacilli
fancier	fanciers
almond	almonds
handler	handlers
hookworm	hookworms
dissenter	dissenters
babysitter	babysitters
odalisque	odalisques
decapod	decapods
wretch	wretches
repository	repositories
passer	passers
portraitist	portraitists
ling	lings
chemist	chemists
diplomat	diplomats
finisher	finishers
crab	crabs
assignee	assignees
kin	kins
necromancer	necromancers
elitist	elitists
wallah	wallahs
bullhead	bullheads
fiancee	fiancees
pollster	pollsters
exhibitionist	exhibitionists
arthropod	arthropods
contestant	contestants
racehorse	racehorses
tuner	tuners
lamb	lambs
lass	lasses
veronica	veronicas
greyhound	greyhounds
predator	predators
jackrabbit	jackrabbits
bee	bees
inferior	inferiors
mayor	mayors
warbler	warblers
performer	performers
rorqual	rorquals
capon	capons
anachronism	anachronisms
second	seconds
aggressor	aggressors
bean	beans
laird	lairds
thatcher	thatchers
stoner	stoners
balsa	balsas
flea	fleas
compatriot	compatriots
homebuilder	homebuilders
bird	birds
lactobacillus	lactobacilli
concessionaire	concessionaires
cooper	coopers
calligrapher	calligraphers
