official	officials
member	members
doe	does
woman	women
child	children
game	games
leader	leaders
player	players
medium	media
worker	workers
student	students
authority	authorities
soldier	soldiers
investor	investors
charge	charges
case	cases
reporter	reporters
sport	sports
stock	stocks
party	parties
analyst	analysts
life	lives
officer	officers
resident	residents
democrat	democrats
friend	friends
parent	parents
voter	voters
fan	fans
victim	victims
expert	experts
foot	feet
employee	employees
hand	hands
republican	republicans
hope	hopes
study	studies
militant	militants
candidate	candidates
minister	ministers
supporter	supporters
name	names
star	stars
citizen	citizens
patient	patients
representative	representatives
customer	customers
champion	champions
second	seconds
lawyer	lawyers
critic	critics
prosecutor	prosecutors
doctor	doctors
civilian	civilians
kid	kids
poll	polls
refugee	refugees
passenger	passengers
face	faces
girl	girls
brother	brothers
plant	plants
head	heads
consumer	consumers
individual	individuals
journalist	journalists
artist	artists
agent	agents
executive	executives
boy	boys
prisoner	prisoners
character	characters
scientist	scientists
material	materials
ally	allies
partner	partners
farmer	farmers
owner	owners
investigator	investigators
guy	guys
visitor	visitors
shot	shots
suspect	suspects
politician	politicians
witness	witnesses
animal	animals
end	ends
client	clients
teacher	teachers
user	users
immigrant	immigrants
writer	writers
letter	letters
tourist	tourists
model	models
terrorist	terrorists
center	centers
judge	judges
tree	trees
serf	serves
dealer	dealers
giant	giants
relative	relatives
son	sons
winner	winners
athlete	athletes
rival	rivals
driver	drivers
diplomat	diplomats
import	imports
casualty	casualties
producer	producers
guard	guards
trader	traders
director	directors
male	males
bird	birds
colleague	colleagues
participant	participants
insurgent	insurgents
observer	observers
female	females
manufacturer	manufacturers
master	masters
neighbor	neighbors
delegate	delegates
adult	adults
inspector	inspectors
survivor	survivors
aide	aides
gunman	gunmen
veteran	veterans
economist	economists
pilot	pilots
page	pages
coach	coaches
host	hosts
machine	machines
editor	editors
tiger	tigers
maker	makers
actor	actors
dog	dogs
guerrilla	guerrillas
president	presidents
rocket	rockets
senator	senators
foreigner	foreigners
king	kings
date	dates
hostage	hostages
guest	guests
person	persons
conservative	conservatives
double	doubles
quarter	quarters
blue	blues
daughter	daughters
engineer	engineers
peacekeeper	peacekeepers
count	counts
flower	flowers
volunteer	volunteers
organizer	organizers
settler	settlers
marine	marines
demonstrator	demonstrators
buyer	buyers
employer	employers
bear	bears
light	lights
dodger	dodgers
advocate	advocates
scholar	scholars
angel	angels
regulator	regulators
wing	wings
musician	musicians
commander	commanders
detainee	detainees
sister	sisters
reader	readers
subject	subjects
instrument	instruments
horse	horses
associate	associates
inhabitant	inhabitants
carrier	carriers
defendant	defendants
policeman	policemen
contact	contacts
bomber	bombers
donor	donors
pirate	pirates
operator	operators
legislator	legislators
cowboy	cowboys
bag	bags
enemy	enemies
retailer	retailers
follower	followers
patriot	patriots
rock	rocks
criminal	criminals
inmate	inmates
crop	crops
adviser	advisers
national	nationals
extremist	extremists
traveler	travelers
teammate	teammates
villager	villagers
connection	connections
governor	governors
professional	professionals
deputy	deputies
cardinal	cardinals
lion	lions
miner	miners
box	boxes
back	backs
priest	priests
suit	suits
mother	mothers
eagle	eagles
voice	voices
negotiator	negotiators
bull	bulls
bishop	bishops
saint	saints
speaker	speakers
ray	rays
monitor	monitors
runner	runners
hero	heroes
juror	jurors
brave	braves
rider	riders
twin	twins
baby	babies
taxpayer	taxpayers
banker	bankers
defender	defenders
communist	communists
developer	developers
ass	assess
provider	providers
contractor	contractors
queen	queens
warrior	warriors
attacker	attackers
prayer	prayers
subscriber	subscribers
historian	historians
bruin	bruins
vegetable	vegetables
permit	permits
specialist	specialists
world	worlds
publisher	publishers
performer	performers
grade	grades
designer	designers
general	generals
fisherman	fishermen
cub	cubs
sailor	sailors
drum	drums
lady	ladies
holder	holders
exporter	exporters
celebrity	celebrities
slave	slaves
migrant	migrants
supplier	suppliers
monk	monks
nurse	nurses
stroke	strokes
nazi	nazis
major	majors
lender	lenders
loser	losers
separatist	separatists
rescuer	rescuers
failure	failures
pledge	pledges
pilgrim	pilgrims
spectator	spectators
bronco	broncos
cat	cats
singer	singers
wife	wives
servant	servants
grandchild	grandchildren
mariner	mariners
architect	architects
creditor	creditors
ash	ashes
bat	bats
seller	sellers
descendant	descendants
ruler	rulers
senior	seniors
liberal	liberals
shark	sharks
dolphin	dolphins
astronaut	astronauts
pitcher	pitchers
satellite	satellites
alumnus	alumni
bean	beans
founder	founders
fly	flies
recipient	recipients
plaintiff	plaintiffs
sort	sorts
dancer	dancers
merchant	merchants
duck	ducks
hawk	hawks
islander	islanders
respondent	respondents
father	fathers
shopper	shoppers
socialist	socialists
trustee	trustees
peer	peers
ambassador	ambassadors
administrator	administrators
transfer	transfers
killer	killers
starter	starters
falcon	falcons
professor	professors
panther	panthers
lover	lovers
tomato	tomatoes
catch	catches
entrepreneur	entrepreneurs
scout	scouts
homeowner	homeowners
nationalist	nationalists
layer	layers
ram	rams
applicant	applicants
classic	classics
kidnapper	kidnappers
recruit	recruits
creature	creatures
fare	fares
sibling	siblings
god	gods
environmentalist	environmentalists
militiaman	militiamen
potato	potatoes
commissioner	commissioners
colt	colts
knight	knights
seeker	seekers
hunter	hunters
guide	guides
insect	insects
personality	personalities
gainer	gainers
photographer	photographers
royal	royals
talent	talents
packer	packers
tackle	tackles
collector	collectors
detective	detectives
mouse	mice
contestant	contestants
buck	bucks
lobbyist	lobbyists
foe	foes
elder	elders
marlin	marlins
wolf	wolves
sun	suns
maverick	mavericks
chicken	chickens
finalist	finalists
composer	composers
advertiser	advertisers
whale	whales
boss	bosses
forward	forwards
rover	rovers
ancestor	ancestors
broadcaster	broadcasters
poet	poets
commentator	commentators
striker	strikers
cow	cows
penguin	penguins
pill	pills
dragon	dragons
rose	roses
builder	builders
cleric	clerics
missionary	missionaries
arrival	arrivals
brake	brakes
predecessor	predecessors
qualifier	qualifiers
borrower	borrowers
serviceman	servicemen
contributor	contributors
martyr	martyrs
mayor	mayors
peasant	peasants
receiver	receivers
laborer	laborers
predator	predators
envoy	envoys
diver	divers
elephant	elephants
loyalist	loyalists
outsider	outsiders
technician	technicians
spy	spies
thief	thieves
mammal	mammals
larva	larvae
brewer	brewers
tenant	tenants
virus	viruses
pain	pains
commando	commandos
pet	pets
seal	seals
grape	grapes
rat	rats
shadow	shadows
patron	patrons
smuggler	smugglers
server	servers
surgeon	surgeons
umpire	umpires
planner	planners
perpetrator	perpetrators
stranger	strangers
retiree	retirees
smoker	smokers
grandparent	grandparents
generator	generators
accessory	accessories
scorer	scorers
newcomer	newcomers
jay	jays
bowler	bowlers
ideal	ideals
intellectual	intellectuals
cousin	cousins
charger	chargers
radical	radicals
ace	aces
bodyguard	bodyguards
batter	batters
oak	oaks
prostitute	prostitutes
organism	organisms
supervisor	supervisors
combatant	combatants
counter	counters
bug	bugs
raven	ravens
warlord	warlords
mourner	mourners
assistant	assistants
mediator	mediators
oiler	oilers
ma	mas
captive	captives
constituent	constituents
hitter	hitters
dam	dams
pioneer	pioneers
beneficiary	beneficiaries
practitioner	practitioners
trainer	trainers
pacer	pacers
onion	onions
affiliate	affiliates
referee	referees
monster	monsters
educator	educators
distributor	distributors
drill	drills
apple	apples
quarterback	quarterbacks
attendant	attendants
grain	grains
native	natives
breeder	breeders
forecaster	forecasters
swimmer	swimmers
husband	husbands
mate	mates
prince	princes
diamondback	diamondbacks
nun	nuns
fence	fences
blade	blades
embryo	embryos
brick	bricks
insider	insiders
monkey	monkeys
birth	births
correspondent	correspondents
skier	skiers
bulldog	bulldogs
snake	snakes
pillar	pillars
chef	chefs
believer	believers
captor	captors
junior	juniors
painter	painters
heir	heirs
processor	processors
escape	escapes
commuter	commuters
spouse	spouses
wildcat	wildcats
rod	rods
watcher	watchers
medic	medics
companion	companions
hornet	hornets
secretary	secretaries
ward	wards
snail	snails
golfer	golfers
orphan	orphans
captain	captains
freshman	freshmen
bandit	bandits
enthusiast	enthusiasts
bidder	bidders
tanker	tankers
slip	slips
kit	kits
auditor	auditors
coyote	coyotes
herb	herbs
square	squares
spokesman	spokesmen
demon	demons
pepper	peppers
dinosaur	dinosaurs
frog	frogs
wanderer	wanderers
cavalier	cavaliers
exile	exiles
cook	cooks
turtle	turtles
destroyer	destroyers
strategist	strategists
cadet	cadets
addict	addicts
compatriot	compatriots
fugitive	fugitives
robber	robbers
creator	creators
man	mans
bee	bees
skater	skaters
gentleman	gentlemen
rail	rails
magistrate	magistrates
mushroom	mushrooms
bureaucrat	bureaucrats
cyclist	cyclists
mercenary	mercenaries
moth	moths
astronomer	astronomers
actress	actresses
homosexual	homosexuals
goat	goats
wrestler	wrestlers
climber	climbers
convict	convicts
successor	successors
principal	principals
taker	takers
invader	invaders
fundamentalist	fundamentalists
voucher	vouchers
westerner	westerners
superior	superiors
reformer	reformers
collaborator	collaborators
congressman	congressmen
jaguar	jaguars
landowner	landowners
promoter	promoters
tribesman	tribesmen
dock	docks
convert	converts
pine	pines
marcher	marchers
rioter	rioters
grader	graders
worm	worms
lesbian	lesbians
fellow	fellows
speculator	speculators
psychologist	psychologists
banana	bananas
rabbi	rabbis
accountant	accountants
trooper	troopers
wallaby	wallabies
printer	printers
villain	villains
contemporary	contemporaries
pedestrian	pedestrians
parliamentarian	parliamentarians
knot	knots
countryman	countrymen
regent	regents
explorer	explorers
programmer	programmers
stakeholder	stakeholders
hybrid	hybrids
attache	attaches
skeptic	skeptics
campaigner	campaigners
hire	hires
clerk	clerks
longhorn	longhorns
heavyweight	heavyweights
murderer	murderers
marshal	marshals
hacker	hackers
advancer	advancers
grizzly	grizzlies
counselor	counselors
ant	ants
teamster	teamsters
crane	cranes
importer	importers
incumbent	incumbents
adversary	adversaries
siren	sirens
peanut	peanuts
regular	regulars
cairn	cairns
tail	tails
recorder	recorders
racer	racers
anchor	anchors
reviewer	reviewers
butterfly	butterflies
gibbon	gibbons
suicide	suicides
ordinary	ordinaries
disciple	disciples
biologist	biologists
palm	palms
evacuee	evacuees
vine	vines
jewel	jewels
duke	dukes
accomplice	accomplices
partisan	partisans
caller	callers
mouth	mouths
pea	peas
bystander	bystanders
mosquito	mosquitoes
appointee	appointees
boxer	boxers
flier	fliers
beetle	beetles
rancher	ranchers
monarch	monarchs
buddy	buddies
entrant	entrants
detractor	detractors
sniper	snipers
brother	brethren
surfer	surfers
adolescent	adolescents
hardliner	hardliners
widow	widows
blogger	bloggers
carrot	carrots
assassin	assassins
rape	rapes
handler	handlers
martin	martins
philosopher	philosophers
gangster	gangsters
parishioner	parishioners
weed	weeds
spider	spiders
soprano	sopranos
landlord	landlords
amateur	amateurs
shrub	shrubs
keeper	keepers
pen	pens
goalkeeper	goalkeepers
substitute	substitutes
onlooker	onlookers
wasp	wasps
chick	chicks
springbok	springboks
shooter	shooters
pollster	pollsters
sympathizer	sympathizers
juvenile	juveniles
stockholder	stockholders
diner	diners
grip	grips
lieutenant	lieutenants
housewife	housewives
olive	olives
reservist	reservists
admirer	admirers
dean	deans
cricketer	cricketers
pickup	pickups
hiker	hikers
bay	bays
oat	oats
finisher	finishers
subordinate	subordinates
violator	violators
reptile	reptiles
owl	owls
orange	oranges
rabbit	rabbits
avenger	avengers
drone	drones
medalist	medalists
thrasher	thrashers
paramedic	paramedics
comedian	comedians
emperor	emperors
conductor	conductors
baron	barons
rush	rushes
clone	clones
crab	crabs
scanner	scanners
thinker	thinkers
escort	escorts
eyewitness	eyewitnesses
cougar	cougars
goose	geese
entertainer	entertainers
songwriter	songwriters
great	greats
paratrooper	paratroopers
clove	cloves
argentine	argentines
fool	fools
stunt	stunts
hog	hogs
oyster	oysters
earner	earners
runner-up	runners-up
conspirator	conspirators
acquaintance	acquaintances
fireman	firemen
rapper	rappers
grass	grasses
breaker	breakers
crewman	crewmen
raiser	raisers
paparazzo	paparazzi
bondholder	bondholders
informant	informants
passer	passers
gambler	gamblers
millionaire	millionaires
apostle	apostles
physicist	physicists
translator	translators
pest	pests
capitalist	capitalists
tom	toms
recruiter	recruiters
cutter	cutters
linebacker	linebackers
child	childs
rocker	rockers
kiwi	kiwis
depositor	depositors
swan	swans
psychiatrist	psychiatrists
jumper	jumpers
presenter	presenters
jockey	jockeys
rodent	rodents
ape	apes
therapist	therapists
parasite	parasites
browser	browsers
pigeon	pigeons
wolverine	wolverines
cleaner	cleaners
strawberry	strawberries
refiner	refiners
gardener	gardeners
exhibitor	exhibitors
beast	beasts
ramp	ramps
vector	vectors
primate	primates
skate	skates
girlfriend	girlfriends
cereal	cereals
claimant	claimants
camper	campers
cube	cubes
idol	idols
reliever	relievers
roble	robles
theorist	theorists
butt	butts
vandal	vandals
meteorologist	meteorologists
pensioner	pensioners
booster	boosters
camel	camels
fish	fishes
preacher	preachers
censor	censors
plotter	plotters
maid	maids
undergraduate	undergraduates
dictator	dictators
searcher	searchers
occupier	occupiers
bride	brides
cracker	crackers
peach	peaches
whaler	whalers
steward	stewards
traitor	traitors
lizard	lizards
bleacher	bleachers
curator	curators
spinner	spinners
industrialist	industrialists
mover	movers
mentor	mentors
laureate	laureates
feminist	feminists
fox	foxes
trainee	trainees
drinker	drinkers
toddler	toddlers
turkey	turkeys
anarchist	anarchists
pharmacist	pharmacists
mountaineer	mountaineers
crow	crows
geologist	geologists
squatter	squatters
prophet	prophets
inventor	inventors
conditioner	conditioners
gymnast	gymnasts
flop	flops
craftsman	craftsmen
interpreter	interpreters
uncle	uncles
beaver	beavers
intruder	intruders
dwarf	dwarfs
canon	canons
underdog	underdogs
moviegoer	moviegoers
financier	financiers
gorilla	gorillas
polluter	polluters
swallow	swallows
waratah	waratahs
nephew	nephews
abuser	abusers
bachelor	bachelors
squirrel	squirrels
microbe	microbes
theologian	theologians
shopkeeper	shopkeepers
columnist	columnists
guardsman	guardsmen
worshiper	worshipers
sprinter	sprinters
bobcat	bobcats
panelist	panelists
reveler	revelers
suitor	suitors
pathogen	pathogens
calf	calves
pointer	pointers
friar	friars
nomad	nomads
angler	anglers
machinist	machinists
policyholder	policyholders
fanatic	fanatics
don	dons
crocodile	crocodiles
roller	rollers
innocent	innocents
shepherd	shepherds
powerhouse	powerhouses
orchid	orchids
examiner	examiners
dentist	dentists
learner	learners
fundraiser	fundraisers
dad	dads
luminary	luminaries
tick	ticks
dissenter	dissenters
hobby	hobbies
aquatic	aquatics
confederate	confederates
pear	pears
almond	almonds
poacher	poachers
waiter	waiters
winger	wingers
saver	savers
robin	robins
bearer	bearers
hind	hinds
archeologist	archeologists
emigrant	emigrants
mathematician	mathematicians
debtor	debtors
dove	doves
bookseller	booksellers
guitarist	guitarists
mutineer	mutineers
caregiver	caregivers
mutant	mutants
pumpkin	pumpkins
eel	eels
clam	clams
cherry	cherries
jack	jacks
renter	renters
lamb	lambs
horseman	horsemen
loggerhead	loggerheads
veterinarian	veterinarians
anomaly	anomalies
admiral	admirals
mussel	mussels
beggar	beggars
cheerleader	cheerleaders
librarian	librarians
bookmaker	bookmakers
watchdog	watchdogs
sewer	sewers
invertebrate	invertebrates
fern	ferns
billionaire	billionaires
hop	hops
magpie	magpies
beard	beards
statesman	statesmen
carpenter	carpenters
mollusk	mollusks
fetus	fetuses
linguist	linguists
puppy	puppies
imam	imams
amphibian	amphibians
anthropologist	anthropologists
chimpanzee	chimpanzees
messenger	messengers
shipper	shippers
earl	earls
intern	interns
pope	popes
roommate	roommates
tout	touts
tier	tiers
cartoonist	cartoonists
kangaroo	kangaroos
victor	victors
coordinator	coordinators
announcer	announcers
quaker	quakers
colonel	colonels
vacationer	vacationers
clown	clowns
patriarch	patriarchs
badger	badgers
sculptor	sculptors
aficionado	aficionados
clergyman	clergymen
eater	eaters
mule	mules
screener	screeners
novelist	novelists
subcontractor	subcontractors
filly	fillies
planter	planters
seedling	seedlings
minnow	minnows
mustang	mustangs
bully	bullies
smith	smiths
catcher	catchers
grandson	grandsons
fascist	fascists
alcoholic	alcoholics
drummer	drummers
lemon	lemons
archer	archers
soloist	soloists
precursor	precursors
cornhusker	cornhuskers
caper	capers
scratch	scratches
freak	freaks
hood	hoods
jurist	jurists
purist	purists
sergeant	sergeants
walnut	walnuts
brit	brits
leopard	leopards
scorpion	scorpions
vulture	vultures
holdout	holdouts
chaplain	chaplains
chemist	chemists
trawler	trawlers
mold	molds
hen	hens
tea	teas
traditionalist	traditionalists
lecturer	lecturers
thrower	throwers
libertarian	libertarians
harlequin	harlequins
poppy	poppies
parrot	parrots
imago	imagines
hound	hounds
cheetah	cheetahs
aristocrat	aristocrats
adventurer	adventurers
referral	referrals
coaster	coasters
matador	matadors
aggressor	aggressors
geek	geeks
petitioner	petitioners
screenwriter	screenwriters
troublemaker	troublemakers
guru	gurus
salesman	salesmen
weaver	weavers
liar	liars
beet	beets
infiltrator	infiltrators
whip	whips
cultivar	cultivars
aunt	aunts
lily	lilies
crustacean	crustaceans
informer	informers
vertebrate	vertebrates
boy	boies
alligator	alligators
baker	bakers
deserter	deserters
drawer	drawers
pianist	pianists
novice	novices
dry	dries
sheriff	sheriffs
scallop	scallops
cameraman	cameramen
animator	animators
snipe	snipes
stud	studs
vigilante	vigilantes
kicker	kickers
deacon	deacons
kite	kites
gladiator	gladiators
milo	milos
magician	magicians
housemate	housemates
accuser	accusers
kink	kinks
dummy	dummies
cedar	cedars
workman	workmen
cranberry	cranberries
sociologist	sociologists
sparrow	sparrows
mare	mares
gull	gulls
pecan	pecans
stockbroker	stockbrokers
coral	corals
blocker	blockers
lobster	lobsters
idiot	idiots
seismologist	seismologists
escapee	escapees
surveyor	surveyors
cucumber	cucumbers
renegade	renegades
salesperson	salespeople
diabetic	diabetics
reed	reeds
outfielder	outfielders
louse	lice
skinhead	skinheads
niece	nieces
princess	princesses
mascot	mascots
steelmaker	steelmakers
mimic	mimics
surrogate	surrogates
fig	figs
arsonist	arsonists
proxy	proxies
superintendent	superintendents
choreographer	choreographers
butcher	butchers
newlywed	newlyweds
aviator	aviators
benefactor	benefactors
cooper	coopers
osprey	ospreys
inductee	inductees
slug	slugs
caterpillar	caterpillars
pup	pups
microorganism	microorganisms
dragoon	dragoons
schoolgirl	schoolgirls
mystic	mystics
heroine	heroines
sophomore	sophomores
rep	reps
backpacker	backpackers
terrier	terriers
shaker	shakers
mite	mites
gopher	gophers
warden	wardens
boyfriend	boyfriends
gendarme	gendarmes
locust	locusts
saboteur	saboteurs
initiate	initiates
wildflower	wildflowers
shallot	shallots
baronet	baronets
temp	temps
snag	snags
atheist	atheists
pony	ponies
self	selves
calculator	calculators
argonaut	argonauts
porter	porters
ass	assesses
archbishop	archbishops
miller	millers
truffle	truffles
mason	masons
sneak	sneaks
clinician	clinicians
maple	maples
medium	mediums
otter	otters
checker	checkers
technocrat	technocrats
shipbuilder	shipbuilders
mangrove	mangroves
struggler	strugglers
caretaker	caretakers
herder	herders
dropout	dropouts
optimist	optimists
emissary	emissaries
mole	moles
feeder	feeders
pedophile	pedophiles
composite	composites
ti	tis
minion	minions
router	routers
misfit	misfits
triplet	triplets
tenor	tenors
oligarch	oligarchs
cockroach	cockroaches
interviewer	interviewers
midshipman	midshipmen
grasshopper	grasshoppers
grocer	grocers
sleeper	sleepers
sinner	sinners
apprentice	apprentices
lama	lamas
biographer	biographers
overseer	overseers
mango	mangoes
digger	diggers
coffee	coffees
paleontologist	paleontologists
perennial	perennials
herald	heralds
picker	pickers
janitor	janitors
signer	signers
tyrant	tyrants
sheik	sheiks
puritan	puritans
centrist	centrists
legionnaire	legionnaires
heron	herons
boarder	boarders
best	bests
lentil	lentils
blueberry	blueberries
snowboarder	snowboarders
stallion	stallions
stilt	stilts
leek	leeks
midwife	midwives
plum	plums
ox	oxen
pea	pease
virgin	virgins
comer	comers
solicitor	solicitors
dick	dicks
seabird	seabirds
creep	creeps
freeman	freemen
statistician	statisticians
termite	termites
sponge	sponges
raspberry	raspberries
cornerback	cornerbacks
denizen	denizens
razorback	razorbacks
ecologist	ecologists
aspirant	aspirants
sage	sages
maroon	maroons
sitter	sitters
musketeer	musketeers
buster	busters
potter	potters
burglar	burglars
tulip	tulips
critter	critters
forebear	forebears
genius	geniuses
laurel	laurels
ringleader	ringleaders
jeweler	jewelers
preschooler	preschoolers
fisher	fishers
thrift	thrifts
constable	constables
sharpshooter	sharpshooters
squire	squires
apache	apaches
cricket	crickets
pelican	pelicans
alderman	aldermen
alto	altos
fielder	fielders
protea	proteas
pursuer	pursuers
congregant	congregants
scapegoat	scapegoats
lancer	lancers
publicist	publicists
marten	martens
waitress	waitresses
outfitter	outfitters
canary	canaries
liberator	liberators
racist	racists
hussar	hussars
hanger	hangers
commoner	commoners
granddaughter	granddaughters
prospector	prospectors
willow	willows
coconut	coconuts
stylist	stylists
usher	ushers
picket	pickets
motorcyclist	motorcyclists
semifinalist	semifinalists
ballplayer	ballplayers
orangutan	orangutans
payer	payers
riser	risers
chestnut	chestnuts
honoree	honorees
academician	academicians
fusilier	fusiliers
nerd	nerds
evangelist	evangelists
kitten	kittens
sardine	sardines
annual	annuals
restaurateur	restaurateurs
licensee	licensees
preservationist	preservationists
liver	livers
gillie	gillies
illustrator	illustrators
serf	serfs
giver	givers
seminarian	seminarians
viper	vipers
philanthropist	philanthropists
cynic	cynics
tortoise	tortoises
coward	cowards
teller	tellers
filibuster	filibusters
purveyor	purveyors
scribe	scribes
harrier	harriers
headliner	headliners
lifeguard	lifeguards
outcast	outcasts
setter	setters
gutter	gutters
bohemian	bohemians
sultan	sultans
conqueror	conquerors
thoroughbred	thoroughbreds
mistress	mistresses
hobbyist	hobbyists
vassal	vassals
belle	belles
cobra	cobras
savage	savages
connoisseur	connoisseurs
forefather	forefathers
secessionist	secessionists
stray	strays
untouchable	untouchables
melon	melons
dreamer	dreamers
heretic	heretics
mint	mints
dwarf	dwarves
sucker	suckers
naysayer	naysayers
grandfather	grandfathers
flea	fleas
vegetarian	vegetarians
artiste	artistes
tracker	trackers
peddler	peddlers
terrapin	terrapins
spender	spenders
pagan	pagans
cattleman	cattlemen
rogue	rogues
facilitator	facilitators
schoolmate	schoolmates
naturalist	naturalists
spammer	spammers
exponent	exponents
stripper	strippers
chancellor	chancellors
vintner	vintners
auctioneer	auctioneers
daisy	daisies
raccoon	raccoons
dispatcher	dispatchers
kingpin	kingpins
freedman	freedmen
groom	grooms
infantryman	infantrymen
navigator	navigators
delinquent	delinquents
skipper	skippers
ham	hams
hack	hacks
llama	llamas
federalist	federalists
spat	spats
arthropod	arthropods
poke	pokes
custodian	custodians
cardholder	cardholders
polyp	polyps
framer	framers
nanny	nannies
artichoke	artichokes
conferee	conferees
gamecock	gamecocks
privateer	privateers
nettle	nettles
pimp	pimps
ancient	ancients
racehorse	racehorses
consul	consuls
scavenger	scavengers
plumber	plumbers
compiler	compilers
flamingo	flamingos
epidemiologist	epidemiologists
spotter	spotters
apricot	apricots
bartender	bartenders
nude	nudes
woodpecker	woodpeckers
repository	repositories
officeholder	officeholders
prawn	prawns
punter	punters
bastard	bastards
distiller	distillers
boa	boas
courtier	courtiers
warbler	warblers
tern	terns
commodore	commodores
lemur	lemurs
amigo	amigos
rightist	rightists
slider	sliders
swift	swifts
electrician	electricians
hotelier	hoteliers
fencer	fencers
botanist	botanists
lime	limes
trapper	trappers
colonialist	colonialists
churchgoer	churchgoers
weightlifter	weightlifters
elm	elms
pike	pikes
storyteller	storytellers
eunuch	eunuchs
schoolboy	schoolboys
dame	dames
mannequin	mannequins
stork	storks
spoiler	spoilers
cock	cocks
executioner	executioners
manatee	manatees
mailer	mailers
watchman	watchmen
hater	haters
widower	widowers
nymph	nymphs
litigant	litigants
ratepayer	ratepayers
canine	canines
roughrider	roughriders
anchovy	anchovies
imperialist	imperialists
cardiologist	cardiologists
marauder	marauders
secularist	secularists
bunny	bunnies
sweetheart	sweethearts
hummingbird	hummingbirds
forester	foresters
layman	laymen
bass	basses
chipmunk	chipmunks
immortal	immortals
barber	barbers
conifer	conifers
squeeze	squeezes
confidant	confidants
spitfire	spitfires
carnivore	carnivores
bettor	bettors
tailor	tailors
abbot	abbots
obstetrician	obstetricians
berk	berks
filer	filers
spacewalker	spacewalkers
demographer	demographers
washer	washers
jerk	jerks
darling	darlings
sunflower	sunflowers
decoy	decoys
grunt	grunts
easterner	easterners
co-star	co-stars
egret	egrets
executor	executors
taster	tasters
avocado	avocados
pessimist	pessimists
fastener	fasteners
carnation	carnations
moss	mosses
colonizer	colonizers
giraffe	giraffes
foal	foals
salamander	salamanders
gatherer	gatherers
excavator	excavators
astrologer	astrologers
globetrotter	globetrotters
changer	changers
drunk	drunks
enrollee	enrollees
confectioner	confectioners
toast	toasts
hoya	hoyas
abolitionist	abolitionists
stowaway	stowaways
personage	personages
scalper	scalpers
playmate	playmates
goldsmith	goldsmiths
private	privates
finch	finches
colonial	colonials
achiever	achievers
eukaryote	eukaryotes
guarantor	guarantors
heterosexual	heterosexuals
infielder	infielders
life	lifes
hyena	hyenas
acrobat	acrobats
realist	realists
upstart	upstarts
stepchild	stepchildren
amputee	amputees
concubine	concubines
cormorant	cormorants
visionary	visionaries
hare	hares
zebra	zebras
rake	rakes
roaster	roasters
emu	emus
lookout	lookouts
agitator	agitators
caterer	caterers
broom	brooms
chronicler	chroniclers
prefect	prefects
urchin	urchins
woman	womens
bushman	bushmen
terror	terrors
romantic	romantics
maggot	maggots
rambler	ramblers
young	youngs
amazon	amazons
trekker	trekkers
interviewee	interviewees
azalea	azaleas
baboon	baboons
ani	anis
lichen	lichens
boatman	boatmen
oppressor	oppressors
sapling	saplings
rusher	rushers
sapper	sappers
boar	boars
partygoer	partygoers
watermelon	watermelons
blackberry	blackberries
ninja	ninjas
fir	firs
molester	molesters
peacock	peacocks
homebuilder	homebuilders
slugger	sluggers
schoolteacher	schoolteachers
wiper	wipers
ethicist	ethicists
gynecologist	gynecologists
impressionist	impressionists
shaman	shamans
aphid	aphids
acolyte	acolytes
songbird	songbirds
balloonist	balloonists
daffodil	daffodils
elk	elks
bailiff	bailiffs
archivist	archivists
conquistador	conquistadors
stag	stags
herbivore	herbivores
dalmatian	dalmatians
holdover	holdovers
stagehand	stagehands
suburbanite	suburbanites
dispenser	dispensers
geneticist	geneticists
ferret	ferrets
wrangler	wranglers
protege	proteges
pheasant	pheasants
finder	finders
sovereign	sovereigns
transsexual	transsexuals
heckler	hecklers
hypocrite	hypocrites
cactus	cacti
supremacist	supremacists
evergreen	evergreens
internee	internees
straggler	stragglers
antelope	antelopes
perch	perches
rook	rooks
legume	legumes
gal	gals
mosquito	mosquitos
pacifist	pacifists
czar	czars
spearhead	spearheads
smut	smuts
appraiser	appraisers
gastropod	gastropods
decorator	decorators
coroner	coroners
hostess	hostesses
violinist	violinists
greyhound	greyhounds
firefly	fireflies
rattlesnake	rattlesnakes
yam	yams
nonsmoker	nonsmokers
shrimp	shrimps
gentile	gentiles
leech	leeches
violet	violets
hillbilly	hillbillies
opposition	oppositions
cartographer	cartographers
automaton	automata
cannibal	cannibals
conservator	conservators
absentee	absentees
python	pythons
strongman	strongmen
draftee	draftees
bedfellow	bedfellows
leper	lepers
maniac	maniacs
noncombatant	noncombatants
opportunist	opportunists
condor	condors
turnip	turnips
dramatist	dramatists
socialite	socialites
petrel	petrels
dishwasher	dishwashers
shortstop	shortstops
sightseer	sightseers
torturer	torturers
grey	greys
nematode	nematodes
instigator	instigators
pollinator	pollinators
ornithologist	ornithologists
geographer	geographers
ostrich	ostriches
freelancer	freelancers
chickpea	chickpeas
hermit	hermits
rifleman	riflemen
kinsman	kinsmen
shipowner	shipowners
barrister	barristers
bot	bots
consort	consorts
butter	butters
mammoth	mammoths
radish	radishes
liquidator	liquidators
tease	teases
hairdresser	hairdressers
plier	pliers
wheeler	wheelers
closer	closers
jackal	jackals
scold	scolds
warner	warners
hooker	hookers
pineapple	pineapples
piper	pipers
florist	florists
cashier	cashiers
tadpole	tadpoles
cipher	ciphers
monarchist	monarchists
moderator	moderators
playmaker	playmakers
gatekeeper	gatekeepers
pallbearer	pallbearers
supermodel	supermodels
registrar	registrars
hatchling	hatchlings
narrator	narrators
castaway	castaways
iris	irises
interlocutor	interlocutors
bather	bathers
apologist	apologists
celebrant	celebrants
housekeeper	housekeepers
agua	aguas
stingray	stingrays
magnolia	magnolias
jogger	joggers
musher	mushers
wearer	wearers
starlet	starlets
grenadier	grenadiers
swinger	swingers
tuner	tuners
mod	mods
psychic	psychics
bison	bisons
cephalopod	cephalopods
modernist	modernists
originator	originators
hominid	hominids
buzzard	buzzards
repeater	repeaters
pusher	pushers
loader	loaders
drake	drakes
blacksmith	blacksmiths
yuppie	yuppies
beekeeper	beekeepers
hopper	hoppers
bouncer	bouncers
bore	bores
vagrant	vagrants
porpoise	porpoises
prankster	pranksters
dragonfly	dragonflies
koala	koalas
pistachio	pistachios
headmaster	headmasters
shire	shires
organist	organists
hamster	hamsters
drafter	drafters
snowball	snowballs
spoonbill	spoonbills
topper	toppers
daredevil	daredevils
centenarian	centenarians
marksman	marksmen
centurion	centurions
ringer	ringers
earthworm	earthworms
sorcerer	sorcerers
torchbearer	torchbearers
limpet	limpets
spokesperson	spokespersons
radiologist	radiologists
hunk	hunks
linesman	linesmen
minstrel	minstrels
vole	voles
pink	pinks
plantain	plantains
macaque	macaques
dieter	dieters
racketeer	racketeers
harvester	harvesters
burgess	burgesses
skateboarder	skateboarders
slacker	slackers
humanist	humanists
putter	putters
roadrunner	roadrunners
ungulate	ungulates
pygmy	pygmies
beef	beefs
holly	hollies
beater	beaters
groupie	groupies
wrongdoer	wrongdoers
sleuth	sleuths
neurologist	neurologists
shorebird	shorebirds
hauler	haulers
prey	preys
antiquary	antiquaries
cicada	cicadas
lunatic	lunatics
roach	roaches
lawman	lawmen
mafioso	mafiosi
tormentor	tormentors
cultist	cultists
trilobite	trilobites
hedgehog	hedgehogs
tackler	tacklers
bridesmaid	bridesmaids
sender	senders
heartbreaker	heartbreakers
primitive	primitives
honeybee	honeybees
gecko	geckos
anesthesiologist	anesthesiologists
chiropractor	chiropractors
kingfisher	kingfishers
arbiter	arbiters
cuckoo	cuckoos
dermatologist	dermatologists
shrew	shrews
techie	techies
hustler	hustlers
sow	sows
eccentric	eccentrics
impersonator	impersonators
overlord	overlords
assemblyman	assemblymen
bard	bards
skunk	skunks
hemophiliac	hemophiliacs
cetacean	cetaceans
agonist	agonists
notary	notaries
sweeper	sweepers
ibis	ibises
starling	starlings
cog	cogs
treasurer	treasurers
welder	welders
toaster	toasters
communicator	communicators
profiteer	profiteers
debater	debaters
chrysanthemum	chrysanthemums
ass	asses
cripple	cripples
selectman	selectmen
headhunter	headhunters
adoptee	adoptees
puppeteer	puppeteers
butler	butlers
caliph	caliphs
bigot	bigots
tailback	tailbacks
papyrus	papyri
bodybuilder	bodybuilders
marsupial	marsupials
augur	augurs
neuroscientist	neuroscientists
hazelnut	hazelnuts
weatherman	weathermen
pornographer	pornographers
eggplant	eggplants
snob	snobs
pomegranate	pomegranates
chorister	choristers
transient	transients
coot	coots
criminologist	criminologists
cavalryman	cavalrymen
slicker	slickers
joker	jokers
blackberry	blackberrys
sealer	sealers
pragmatist	pragmatists
wag	wags
valentine	valentines
cabbage	cabbages
sharecropper	sharecroppers
weasel	weasels
neutral	neutrals
prodigy	prodigies
gourd	gourds
bitch	bitches
snatcher	snatchers
invalid	invalids
ballerina	ballerinas
ayatollah	ayatollahs
transvestite	transvestites
modifier	modifiers
lyricist	lyricists
conventioneer	conventioneers
playboy	playboys
minder	minders
guzzler	guzzlers
rustler	rustlers
collegian	collegians
metropolitan	metropolitans
pivot	pivots
freeholder	freeholders
barnacle	barnacles
grandmaster	grandmasters
idealist	idealists
coon	coons
retriever	retrievers
stringer	stringers
oncologist	oncologists
evaluator	evaluators
bootlegger	bootleggers
wright	wrights
engraver	engravers
nighthawk	nighthawks
wimp	wimps
bellwether	bellwethers
chandler	chandlers
experimenter	experimenters
lark	larks
chap	chaps
parachutist	parachutists
khan	khans
councilman	councilmen
crazy	crazies
outlier	outliers
loon	loons
carter	carters
registrant	registrants
currant	currants
dresser	dressers
vicar	vicars
spokeswoman	spokeswomen
marathoner	marathoners
canvasser	canvassers
copycat	copycats
outpatient	outpatients
plover	plovers
sire	sires
savior	saviors
skimmer	skimmers
decoder	decoders
zoologist	zoologists
in-law	in-laws
stalker	stalkers
shaver	shavers
blaster	blasters
turner	turners
lilac	lilacs
waif	waives
weevil	weevils
insectivore	insectivores
burro	burros
flicker	flickers
shipmate	shipmates
moralist	moralists
teaser	teasers
futurist	futurists
bivalve	bivalves
albatross	albatrosses
neoconservative	neoconservatives
tramp	tramps
progenitor	progenitors
neophyte	neophytes
piglet	piglets
backbencher	backbenchers
commando	commandoes
pterosaur	pterosaurs
denier	deniers
arranger	arrangers
smallholder	smallholders
genealogist	genealogists
orator	orators
sierra	sierras
tripper	trippers
juggler	jugglers
commissar	commissars
emir	emirs
hunter-gatherer	hunter-gatherers
blackbird	blackbirds
namesake	namesakes
hero	heros
adjuster	adjusters
rhododendron	rhododendrons
entomologist	entomologists
nigger	niggers
businesswoman	businesswomen
clansman	clansmen
scab	scabs
philistine	philistines
warder	warders
underachiever	underachievers
octopus	octopuses
lemming	lemmings
grebe	grebes
tetrapod	tetrapods
gazelle	gazelles
bloomer	bloomers
bedbug	bedbugs
hawthorn	hawthorns
wisp	wisps
sandpiper	sandpipers
trailblazer	trailblazers
lackey	lackeys
pickpocket	pickpockets
cashew	cashews
barbu	barbus
hummer	hummers
yeoman	yeomen
mew	mews
cowgirl	cowgirls
animist	animists
peony	peonies
anemone	anemones
armadillo	armadillos
wailer	wailers
wrecker	wreckers
redneck	rednecks
gawker	gawkers
chameleon	chameleons
wren	wrens
broad	broads
quail	quails
corsair	corsairs
propagandist	propagandists
revisionist	revisionists
heavy	heavies
exchanger	exchangers
concessionaire	concessionaires
ewe	ewes
percussionist	percussionists
bramble	brambles
voyager	voyagers
caveman	cavemen
fancier	fanciers
surrealist	surrealists
thrush	thrushes
tangerine	tangerines
waver	wavers
tuna	tunas
ophthalmologist	ophthalmologists
feline	felines
herring	herrings
swindler	swindlers
lifer	lifers
reactionary	reactionaries
divider	dividers
saxophonist	saxophonists
fullback	fullbacks
yeast	yeasts
godfather	godfathers
humpback	humpbacks
pupa	pupae
mandarin	mandarins
stewardess	stewardesses
macaw	macaws
raja	rajas
prokaryote	prokaryotes
mouthpiece	mouthpieces
godparent	godparents
theropod	theropods
slaveholder	slaveholders
crawler	crawlers
sloth	sloths
mugger	muggers
sauropod	sauropods
bisexual	bisexuals
gaucho	gauchos
expressionist	expressionists
nester	nesters
isolationist	isolationists
mestizo	mestizos
tarantula	tarantulas
marigold	marigolds
tracer	tracers
patrician	patricians
cottager	cottagers
forger	forgers
bongo	bongos
debutante	debutantes
bassist	bassists
bittern	bitterns
ruminant	ruminants
stationer	stationers
domestic	domestics
wallflower	wallflowers
poodle	poodles
houseplant	houseplants
manipulator	manipulators
hydrangea	hydrangeas
whelk	whelks
piranha	piranhas
submariner	submariners
copepod	copepods
grub	grubs
duckling	ducklings
faller	fallers
undesirable	undesirables
neurosurgeon	neurosurgeons
dingo	dingoes
preteen	preteens
appellant	appellants
receptionist	receptionists
geranium	geraniums
mallard	mallards
oilman	oilmen
kiddy	kiddies
priestess	priestesses
booby	boobies
skydiver	skydivers
musicologist	musicologists
better	betters
hysteric	hysterics
newscaster	newscasters
walrus	walruses
nectarine	nectarines
partridge	partridges
nonmember	nonmembers
retrovirus	retroviruses
skullcap	skullcaps
speller	spellers
breadwinner	breadwinners
lobsterman	lobstermen
camellia	camellias
cichlid	cichlids
ombudsman	ombudsmen
modern	moderns
viola	violas
penetrator	penetrators
newt	newts
bluebird	bluebirds
yak	yaks
pansy	pansies
panhandler	panhandlers
viscount	viscounts
loner	loners
cyborg	cyborgs
optometrist	optometrists
corporal	corporals
endorser	endorsers
seer	seers
bargainer	bargainers
defaulter	defaulters
poplar	poplars
grantee	grantees
trumpeter	trumpeters
stevedore	stevedores
climatologist	climatologists
inquisitor	inquisitors
cockle	cockles
gent	gents
darter	darters
tusker	tuskers
overachiever	overachievers
comma	commas
cosmologist	cosmologists
pharisee	pharisees
pauper	paupers
scion	scions
diatom	diatoms
grammarian	grammarians
bluewing	bluewings
scad	scads
alchemist	alchemists
spaniel	spaniels
dun	duns
wattle	wattles
puffin	puffins
acquirer	acquirers
repatriate	repatriates
stepson	stepsons
vegan	vegans
thistle	thistles
stiff	stiffs
maestro	maestros
yachtsman	yachtsmen
demagogue	demagogues
squid	squids
morel	morels
creeper	creepers
kingmaker	kingmakers
taxonomist	taxonomists
prior	priors
adulterer	adulterers
lettuce	lettuces
mara	maras
gondolier	gondoliers
midge	midges
quadruplet	quadruplets
sable	sables
scriptwriter	scriptwriters
tanner	tanners
tribune	tribunes
heathen	heathens
parakeet	parakeets
yeoman	yeomans
scofflaw	scofflaws
photojournalist	photojournalists
pervert	perverts
cactus	cactuses
procurator	procurators
astrophysicist	astrophysicists
sedge	sedges
appropriator	appropriators
avocet	avocets
shrike	shrikes
dogwood	dogwoods
repairman	repairmen
militarist	militarists
stepdaughter	stepdaughters
active	actives
natural	naturals
salmon	salmons
psychotherapist	psychotherapists
malcontent	malcontents
passerine	passerines
fluke	flukes
sunbather	sunbathers
cobbler	cobblers
cob	cobs
angiosperm	angiosperms
anachronism	anachronisms
tumbleweed	tumbleweeds
silverback	silverbacks
chinook	chinooks
alpaca	alpacas
besieger	besiegers
dervish	dervishes
bombshell	bombshells
petter	petters
deadhead	deadheads
gnat	gnats
groundling	groundlings
scrubber	scrubbers
seahorse	seahorses
mink	minks
webmaster	webmasters
quintuplet	quintuplets
stater	staters
auteur	auteurs
birch	birches
nestling	nestlings
bunting	buntings
mime	mimes
mango	mangos
speechwriter	speechwriters
latecomer	latecomers
cherub	cherubs
gannet	gannets
canoeist	canoeists
screamer	screamers
barnstormer	barnstormers
donna	donnas
gringo	gringos
floater	floaters
brachiopod	brachiopods
papaya	papayas
civet	civets
janissary	janissaries
parsnip	parsnips
sycamore	sycamores
agnostic	agnostics
bunt	bunts
omnivore	omnivores
hugger	huggers
beagle	beagles
bumblebee	bumblebees
ironworker	ironworkers
stargazer	stargazers
schizophrenic	schizophrenics
kook	kooks
flounder	flounders
cantor	cantors
nonresident	nonresidents
libertine	libertines
snoop	snoops
calligrapher	calligraphers
opossum	opossums
dependant	dependants
demigod	demigods
dandelion	dandelions
porcupine	porcupines
switcher	switchers
confidante	confidantes
moneymaker	moneymakers
illiterate	illiterates
arachnid	arachnids
matron	matrons
adjunct	adjuncts
mute	mutes
classifier	classifiers
strangler	stranglers
silkworm	silkworms
maestro	maestri
ladybug	ladybugs
woodworker	woodworkers
slaver	slavers
satirist	satirists
bricklayer	bricklayers
skink	skinks
capuchin	capuchins
runner-up	runner-ups
persimmon	persimmons
oarsman	oarsmen
empress	empresses
vixen	vixens
hammerhead	hammerheads
anteater	anteaters
grandee	grandees
matchmaker	matchmakers
voyeur	voyeurs
lightweight	lightweights
shearwater	shearwaters
instar	instars
bloodhound	bloodhounds
waxwing	waxwings
picnicker	picnickers
pleaser	pleasers
desperado	desperados
foreman	foremen
lovebird	lovebirds
nightingale	nightingales
bamboo	bamboos
hitchhiker	hitchhikers
imp	imps
jester	jesters
viceroy	viceroys
puller	pullers
kamikaze	kamikazes
quack	quacks
tomatillo	tomatillos
collie	collies
pooch	pooches
herbalist	herbalists
nawab	nawabs
whiner	whiners
workhorse	workhorses
tinker	tinkers
shocker	shockers
mimosa	mimosas
ensign	ensigns
dumbbell	dumbbells
headman	headmen
lister	listers
petunia	petunias
apparatchik	apparatchiks
mullet	mullets
eaglet	eaglets
worthy	worthies
orderly	orderlies
raver	ravers
goby	gobies
oblate	oblates
hoarder	hoarders
heath	heaths
squash	squashes
cockatoo	cockatoos
cellist	cellists
dahlia	dahlias
barracuda	barracudas
beech	beeches
virtuoso	virtuosos
collard	collards
elitist	elitists
hotdog	hotdogs
caster	casters
snapper	snappers
begonia	begonias
lapwing	lapwings
valet	valets
oceanographer	oceanographers
bullock	bullocks
sower	sowers
homeboy	homeboys
granny	grannies
sophisticate	sophisticates
pussycat	pussycats
bullfighter	bullfighters
newsagent	newsagents
preserver	preservers
bugle	bugles
divorcee	divorcees
geezer	geezers
fixer	fixers
poinsettia	poinsettias
splitter	splitters
microbiologist	microbiologists
nudist	nudists
hurdler	hurdlers
echinoderm	echinoderms
docent	docents
yearling	yearlings
showman	showmen
sprayer	sprayers
pangolin	pangolins
nonconformist	nonconformists
millipede	millipedes
tumbler	tumblers
oystercatcher	oystercatchers
flanker	flankers
asthmatic	asthmatics
forager	foragers
succulent	succulents
charmer	charmers
paralegal	paralegals
margrave	margraves
centipede	centipedes
polygamist	polygamists
hyacinth	hyacinths
crooner	crooners
skirmisher	skirmishers
mockingbird	mockingbirds
sawyer	sawyers
farmhand	farmhands
nuthatch	nuthatches
exploiter	exploiters
rhinoceros	rhinoceroses
ethnic	ethnics
codefendant	codefendants
gossip	gossips
pipit	pipits
fishmonger	fishmongers
usurper	usurpers
capo	capos
rapporteur	rapporteurs
chink	chinks
catfish	catfishes
marmot	marmots
philatelist	philatelists
suppressor	suppressors
heather	heathers
workaholic	workaholics
silversmith	silversmiths
criollo	criollos
legate	legates
striper	stripers
typist	typists
watchmaker	watchmakers
plebeian	plebeians
kestrel	kestrels
abortionist	abortionists
conquistador	conquistadores
chickadee	chickadees
peeper	peepers
vaulter	vaulters
choker	chokers
agronomist	agronomists
skua	skuas
internationalist	internationalists
reincarnation	reincarnations
protectionist	protectionists
leaker	leakers
groundnut	groundnuts
probiotic	probiotics
sycophant	sycophants
wagtail	wagtails
steed	steeds
mastodon	mastodons
yogi	yogis
babbler	babblers
peri	peris
joiner	joiners
curate	curates
automaton	automatons
carpetbagger	carpetbaggers
townsman	townsmen
booker	bookers
huckster	hucksters
lamprey	lampreys
borderer	borderers
probable	probables
hermaphrodite	hermaphrodites
sissy	sissies
probationer	probationers
barker	barkers
hornbill	hornbills
kookaburra	kookaburras
suffragette	suffragettes
hart	harts
procrastinator	procrastinators
roofer	roofers
brawler	brawlers
concierge	concierges
tamarin	tamarins
physiologist	physiologists
individualist	individualists
sturgeon	sturgeons
ironside	ironsides
guillemot	guillemots
schemer	schemers
artilleryman	artillerymen
modeler	modelers
cotton	cottons
rue	rues
humanitarian	humanitarians
imposter	imposters
horticulturist	horticulturists
whiff	whiffs
suffragist	suffragists
humorist	humorists
lout	louts
fledgling	fledglings
knitter	knitters
marquess	marquesses
hemlock	hemlocks
locator	locators
speedskater	speedskaters
penitent	penitents
vaquero	vaqueros
brother-in-law	brothers-in-law
sommelier	sommeliers
frontiersman	frontiersmen
protist	protists
nutcracker	nutcrackers
gallinule	gallinules
chit	chits
urologist	urologists
sadhu	sadhus
draper	drapers
printmaker	printmakers
maharaja	maharajas
babysitter	babysitters
straphanger	straphangers
cycad	cycads
cypress	cypresses
gerbil	gerbils
bracero	braceros
sojourner	sojourners
heifer	heifers
albino	albinos
satyr	satyrs
clothier	clothiers
crake	crakes
seaweed	seaweeds
obstructionist	obstructionists
provincial	provincials
postmaster	postmasters
bracken	brackens
amphipod	amphipods
religionist	religionists
aspen	aspens
undersecretary	undersecretaries
clover	clovers
salvager	salvagers
baritone	baritones
corn	corns
grison	grisons
redcoat	redcoats
redhead	redheads
greeter	greeters
busker	buskers
stepper	steppers
sorter	sorters
ornamental	ornamentals
mayfly	mayflies
luthier	luthiers
iconoclast	iconoclasts
tapper	tappers
cantaloupe	cantaloupes
acceptor	acceptors
grabber	grabbers
essayist	essayists
geophysicist	geophysicists
tipster	tipsters
cuirassier	cuirassiers
wombat	wombats
optician	opticians
damsel	damsels
langur	langurs
toastmaster	toastmasters
abomination	abominations
survivalist	survivalists
man-at-arms	men-at-arms
blackmailer	blackmailers
prowler	prowlers
archosaur	archosaurs
inpatient	inpatients
virologist	virologists
warthog	warthogs
understudy	understudies
internist	internists
racker	rackers
adjudicator	adjudicators
exterminator	exterminators
jackrabbit	jackrabbits
bustard	bustards
weekender	weekenders
curlew	curlews
waif	waifs
chanterelle	chanterelles
bullfrog	bullfrogs
mustard	mustards
milkman	milkmen
grouper	groupers
pitchman	pitchmen
myrtle	myrtles
dugong	dugongs
laird	lairds
sheepherder	sheepherders
letterman	lettermen
tapir	tapirs
televangelist	televangelists
muskrat	muskrats
lioness	lionesses
damselfly	damselflies
quarryman	quarrymen
couturier	couturiers
perfectionist	perfectionists
stoic	stoics
lexicographer	lexicographers
spruce	spruces
gravedigger	gravediggers
aster	asters
slammer	slammers
ouster	ousters
genius	genii
godwit	godwits
bantam	bantams
rectifier	rectifiers
bacillus	bacilli
liverwort	liverworts
tactician	tacticians
tanager	tanagers
cottonwood	cottonwoods
brigadier	brigadiers
leaseholder	leaseholders
personification	personifications
coauthor	coauthors
pachyderm	pachyderms
triton	tritons
meerkat	meerkats
cattail	cattails
arbor	arbors
biennial	biennials
skinner	skinners
dinoflagellate	dinoflagellates
agriculturist	agriculturists
reenactor	reenactors
venturer	venturers
mongoose	mongooses
lessor	lessors
toxicologist	toxicologists
tiller	tillers
endemic	endemics
neonate	neonates
eavesdropper	eavesdroppers
ivy	ivies
grandma	grandmas
edger	edgers
doughboy	doughboys
busboy	busboys
alder	alders
quitter	quitters
stonecutter	stonecutters
fawn	fawns
plesiosaur	plesiosaurs
embodiment	embodiments
copperhead	copperheads
slinger	slingers
wayfarer	wayfarers
anatomist	anatomists
cherub	cherubim
dandy	dandies
tagger	taggers
rice	rices
woodcutter	woodcutters
crocus	crocuses
halfback	halfbacks
deer	deers
classicist	classicists
beachcomber	beachcombers
shiner	shiners
groundhog	groundhogs
flamingo	flamingoes
drunkard	drunkards
flapper	flappers
grapefruit	grapefruits
fitter	fitters
superbug	superbugs
biochemist	biochemists
ethnographer	ethnographers
virtuoso	virtuosi
gelding	geldings
dyer	dyers
bryozoan	bryozoans
bacteriophage	bacteriophages
toucan	toucans
transgressor	transgressors
insomniac	insomniacs
guppy	guppies
slouch	slouches
foot	foots
outrider	outriders
pushover	pushovers
logician	logicians
sphinx	sphinxes
contrarian	contrarians
puncher	punchers
minimalist	minimalists
freeloader	freeloaders
sniffer	sniffers
slob	slobs
lagomorph	lagomorphs
coachbuilder	coachbuilders
gymnosperm	gymnosperms
crimp	crimps
mercer	mercers
pentathlete	pentathletes
matriarch	matriarchs
hellion	hellions
shearer	shearers
monopolist	monopolists
marmoset	marmosets
willet	willets
mortician	morticians
windowpane	windowpanes
grouse	grouses
periwinkle	periwinkles
hearer	hearers
dacoit	dacoits
choirboy	choirboys
rigger	riggers
caroler	carolers
offspring	offsprings
plunderer	plunderers
saki	sakis
patroller	patrollers
luger	lugers
guava	guavas
plutocrat	plutocrats
peshmerga	peshmergas
bimbo	bimbos
nominator	nominators
jaeger	jaegers
anaconda	anacondas
bryophyte	bryophytes
auk	auks
kudu	kudus
ringlet	ringlets
bandleader	bandleaders
annelid	annelids
ratite	ratites
desperado	desperadoes
sociopath	sociopaths
stoner	stoners
zinnia	zinnias
schoolmaster	schoolmasters
fingerling	fingerlings
harvestman	harvestmen
satrap	satraps
middleweight	middleweights
clapper	clappers
remover	removers
monotreme	monotremes
brahman	brahmans
masseur	masseurs
egghead	eggheads
polychaete	polychaetes
groomsman	groomsmen
balsam	balsams
tapeworm	tapeworms
blond	blonds
flatworm	flatworms
paymaster	paymasters
bugler	buglers
lotus	lotuses
heartthrob	heartthrobs
proletarian	proletarians
shogun	shoguns
bey	beys
alarmist	alarmists
monocot	monocots
cubist	cubists
son-in-law	sons-in-law
crofter	crofters
heiress	heiresses
woodcock	woodcocks
confessor	confessors
bushwhacker	bushwhackers
persuader	persuaders
spy	spiess
salter	salters
pika	pikas
trogon	trogons
endocrinologist	endocrinologists
pug	pugs
rosebud	rosebuds
lumberman	lumbermen
fossa	fossae
chump	chumps
kitty	kitties
cabinetmaker	cabinetmakers
proctor	proctors
fiduciary	fiduciaries
stockman	stockmen
hygienist	hygienists
titmouse	titmice
married	marrieds
gangsta	gangstas
dachshund	dachshunds
theosophist	theosophists
kumquat	kumquats
kittiwake	kittiwakes
pawnbroker	pawnbrokers
deliveryman	deliverymen
ghostwriter	ghostwriters
mufti	muftis
spinster	spinsters
weakling	weaklings
venter	venters
dunce	dunces
beluga	belugas
shill	shills
octogenarian	octogenarians
disbeliever	disbelievers
stenographer	stenographers
torero	toreros
slasher	slashers
vireo	vireos
truant	truants
philologist	philologists
constitutionalist	constitutionalists
bulbul	bulbuls
gunsmith	gunsmiths
lodger	lodgers
earwig	earwigs
phalarope	phalaropes
jobber	jobbers
mantis	mantises
tyrannosaur	tyrannosaurs
troubleshooter	troubleshooters
orthodontist	orthodontists
crinoid	crinoids
shipwright	shipwrights
masseuse	masseuses
courser	coursers
hippopotamus	hippopotamuses
mastiff	mastiffs
saguaro	saguaros
cosmopolitan	cosmopolitans
communicant	communicants
chough	choughs
acacia	acacias
educationist	educationists
muralist	muralists
countrywoman	countrywomen
stoat	stoats
grackle	grackles
warhorse	warhorses
tinamou	tinamous
handyman	handymen
tamer	tamers
hoper	hopers
bighorn	bighorns
mater	maters
kinglet	kinglets
thresher	threshers
biter	biters
familiar	familiars
mycologist	mycologists
hierarch	hierarchs
keyboardist	keyboardists
tobacconist	tobacconists
wildcatter	wildcatters
macho	machos
hydrologist	hydrologists
vizier	viziers
footman	footmen
suffragan	suffragans
wretch	wretches
cutthroat	cutthroats
sod	sods
sidewinder	sidewinders
stablemate	stablemates
tinkerer	tinkerers
stickler	sticklers
churchwarden	churchwardens
franklin	franklins
copyist	copyists
syndicator	syndicators
woman	womans
pratincole	pratincoles
corgi	corgis
provost	provosts
harpy	harpies
draftsman	draftsmen
worrier	worriers
bluebonnet	bluebonnets
beatnik	beatniks
presbyter	presbyters
leviathan	leviathans
sleepwalker	sleepwalkers
pitta	pittas
fuller	fullers
gardenia	gardenias
embalmer	embalmers
caiman	caimans
chartist	chartists
bondsman	bondsmen
narcissist	narcissists
knocker	knockers
headmistress	headmistresses
caracara	caracaras
griot	griots
clementine	clementines
geisha	geishas
sir	sirs
barbet	barbets
publican	publicans
deist	deists
crackpot	crackpots
pinto	pintos
streetwalker	streetwalkers
symbolist	symbolists
wolfhound	wolfhounds
fink	finks
duffer	duffers
orientalist	orientalists
governess	governesses
copper	coppers
duchess	duchesses
bibliophile	bibliophiles
beautician	beauticians
hoopoe	hoopoes
pinwheel	pinwheels
immunologist	immunologists
yew	yews
dairyman	dairymen
roundhead	roundheads
freeman	freemans
poseur	poseurs
mahout	mahouts
lady-in-waiting	ladies-in-waiting
woodsman	woodsmen
conch	conchs
epileptic	epileptics
foxhound	foxhounds
bombardier	bombardiers
cofounder	cofounders
simian	simians
peregrine	peregrines
airhead	airheads
hyrax	hyraxes
unfortunate	unfortunates
sculler	scullers
deceiver	deceivers
snook	snooks
impala	impalas
murre	murres
locksmith	locksmiths
mulatto	mulattoes
mamba	mambas
varmint	varmints
aerialist	aerialists
workmate	workmates
wingman	wingmen
stoker	stokers
sadist	sadists
revolutionist	revolutionists
perfumer	perfumers
therapsid	therapsids
ripper	rippers
neurotic	neurotics
liana	lianas
mantis	mantes
miler	milers
dotterel	dotterels
amniote	amniotes
hangman	hangmen
carp	carps
careerist	careerists
coachman	coachmen
contortionist	contortionists
dowitcher	dowitchers
aloe	aloes
conspecific	conspecifics
toiler	toilers
cacique	caciques
inferior	inferiors
diviner	diviners
rust	rusts
accompanist	accompanists
copywriter	copywriters
welterweight	welterweights
tetra	tetras
tattler	tattlers
absconder	absconders
newsreader	newsreaders
veronica	veronicas
ectoparasite	ectoparasites
alpinist	alpinists
medusa	medusae
scarab	scarabs
metallurgist	metallurgists
chamberlain	chamberlains
skivvy	skivvies
haricot	haricots
siskin	siskins
lynx	lynxes
technophile	technophiles
bilingual	bilinguals
stepparent	stepparents
broodmare	broodmares
rue	ruess
junco	juncos
balsa	balsas
adder	adders
ichthyosaur	ichthyosaurs
numismatist	numismatists
dynast	dynasts
convener	conveners
stayer	stayers
asp	asps
spymaster	spymasters
catechist	catechists
timekeeper	timekeepers
chordate	chordates
eland	elands
librettist	librettists
messiah	messiahs
tunicate	tunicates
exhibitionist	exhibitionists
regicide	regicides
ideologist	ideologists
nihilist	nihilists
incompetent	incompetents
valedictorian	valedictorians
bookkeeper	bookkeepers
chapman	chapmans
bovine	bovines
old-timer	old-timers
glassmaker	glassmakers
deliverer	deliverers
fossa	fossas
roper	ropers
hotspur	hotspurs
archdeacon	archdeacons
manta	mantas
pia	pias
nativist	nativists
caecilian	caecilians
dodo	dodos
tucker	tuckers
quadruped	quadrupeds
castrato	castrati
peeler	peelers
outdoorsman	outdoorsmen
streaker	streakers
oldster	oldsters
behaviorist	behaviorists
nailer	nailers
psychotic	psychotics
gleaner	gleaners
deckhand	deckhands
evolutionist	evolutionists
stepbrother	stepbrothers
bankrupt	bankrupts
pasha	pashas
quetzal	quetzals
exorcist	exorcists
tobacco	tobaccos
guesser	guessers
mealybug	mealybugs
abbess	abbesses
ocelot	ocelots
primrose	primroses
hag	hags
chauvinist	chauvinists
authoritarian	authoritarians
harpist	harpists
fetishist	fetishists
equine	equines
catechumen	catechumens
herpetologist	herpetologists
redeemer	redeemers
ethnologist	ethnologists
hake	hakes
char	chars
papist	papists
millet	millets
pruner	pruners
isopod	isopods
wordsmith	wordsmiths
shiitake	shiitakes
hickory	hickories
doge	doges
canna	cannas
mako	makos
manicurist	manicurists
ceratopsian	ceratopsians
wheat	wheats
tang	tangs
positivist	positivists
echidna	echidnas
gooseberry	gooseberries
telecaster	telecasters
teetotaler	teetotalers
rainmaker	rainmakers
rutabaga	rutabagas
idler	idlers
fulmar	fulmars
saddler	saddlers
schmuck	schmucks
tarsier	tarsiers
nasturtium	nasturtiums
falconer	falconers
occultist	occultists
whistler	whistlers
introvert	introverts
anti	antis
sundowner	sundowners
synapsid	synapsids
paraplegic	paraplegics
constrictor	constrictors
possible	possibles
harasser	harassers
skycap	skycaps
ambusher	ambushers
hydra	hydrae
protozoan	protozoans
merozoite	merozoites
arbitrageur	arbitrageurs
peccary	peccaries
hadrosaur	hadrosaurs
whitefly	whiteflies
loach	loaches
potato	potatos
polytheist	polytheists
rotifer	rotifers
blastocyst	blastocysts
crossbill	crossbills
derelict	derelicts
orthopedist	orthopedists
deaconess	deaconesses
obsessive	obsessives
gar	gars
absolutist	absolutists
glutton	gluttons
mulberry	mulberries
victimizer	victimizers
iceman	icemen
dressmaker	dressmakers
homo	homos
velociraptor	velociraptors
bairn	bairns
cowbird	cowbirds
fortuneteller	fortunetellers
huckleberry	huckleberries
allergist	allergists
abbe	abbes
gazetteer	gazetteers
fiancee	fiancees
scrutineer	scrutineers
simple	simples
redwing	redwings
blenny	blennies
puffer	puffers
marquis	marquises
mealworm	mealworms
hollyhock	hollyhocks
signalman	signalmen
ginger	gingers
baby	babys
lilliputian	lilliputians
conch	conches
winder	winders
quadriplegic	quadriplegics
mulatto	mulattos
grazier	graziers
colossus	colossi
addressee	addressees
materialist	materialists
trustbuster	trustbusters
nabob	nabobs
busybody	busybodies
gamekeeper	gamekeepers
hellebore	hellebores
pilchard	pilchards
ingenue	ingenues
gobbler	gobblers
snapdragon	snapdragons
fly	flys
swami	swamis
constructivist	constructivists
scalawag	scalawags
plenipotentiary	plenipotentiaries
fowler	fowlers
pharmacologist	pharmacologists
skylark	skylarks
bent	bents
agave	agaves
strider	striders
chinchilla	chinchillas
crier	criers
abstainer	abstainers
chiton	chitons
scratcher	scratchers
madam	madams
cowpea	cowpeas
prosimian	prosimians
anglophile	anglophiles
miser	misers
taipan	taipans
aardvark	aardvarks
quartermaster	quartermasters
plasterer	plasterers
kob	kobs
australopithecine	australopithecines
sporozoite	sporozoites
gunrunner	gunrunners
catbird	catbirds
propagator	propagators
whippet	whippets
gosling	goslings
cad	cads
polymorph	polymorphs
princeling	princelings
smasher	smashers
greaser	greasers
gadfly	gadflies
weeper	weepers
landlubber	landlubbers
coreligionist	coreligionists
goshawk	goshawks
wrasse	wrasses
teal	teals
esquire	esquires
leafhopper	leafhoppers
postdoc	postdocs
anaerobe	anaerobes
upholder	upholders
ciliate	ciliates
millwright	millwrights
pledger	pledgers
literate	literates
shutterbug	shutterbugs
masochist	masochists
chewer	chewers
agama	agamas
trombonist	trombonists
paraprofessional	paraprofessionals
tipper	tippers
lorikeet	lorikeets
coelacanth	coelacanths
jackdaw	jackdaws
adjutant	adjutants
polecat	polecats
pinscher	pinschers
homophobe	homophobes
orchestrator	orchestrators
transcendentalist	transcendentalists
lacewing	lacewings
salmonid	salmonids
waverer	waverers
gastroenterologist	gastroenterologists
bobby	bobbies
kin	kins
front-runner	front-runners
monad	monads
seagrass	seagrasses
valuer	valuers
buttercup	buttercups
vaudevillian	vaudevillians
chaperon	chaperons
colorist	colorists
necromancer	necromancers
palomino	palominos
plater	platers
horsetail	horsetails
bulrush	bulrushes
lurker	lurkers
theist	theists
appeaser	appeasers
gigolo	gigolos
gerontologist	gerontologists
clairvoyant	clairvoyants
nan	nans
balancer	balancers
sledder	sledders
anorexic	anorexics
totalitarian	totalitarians
praetor	praetors
hedonist	hedonists
clarinetist	clarinetists
disputant	disputants
yokel	yokels
broker-dealer	broker-dealers
qadi	qadis
stepmother	stepmothers
itinerant	itinerants
softy	softies
biped	bipeds
playgoer	playgoers
foundling	foundlings
ctenophore	ctenophores
accentor	accentors
trouper	troupers
cutler	cutlers
gouger	gougers
muckraker	muckrakers
taxidermist	taxidermists
hazel	hazels
portraitist	portraitists
flunky	flunkies
berserker	berserkers
zooid	zooids
stand-in	stand-ins
ruff	ruffs
scoutmaster	scoutmasters
codger	codgers
wolf	wolfs
gametophyte	gametophytes
mouse	mouses
adenovirus	adenoviruses
jobholder	jobholders
bandmaster	bandmasters
peppermint	peppermints
highflier	highfliers
accordionist	accordionists
idolater	idolaters
hireling	hirelings
sodomite	sodomites
diarist	diarists
katydid	katydids
kale	kales
fiance	fiances
sipper	sippers
metalhead	metalheads
charioteer	charioteers
greengrocer	greengrocers
godchild	godchildren
jaywalker	jaywalkers
groundsman	groundsmen
bolete	boletes
dormouse	dormice
stander	standers
bookworm	bookworms
left-hander	left-handers
capybara	capybaras
archduke	archdukes
quince	quinces
bitterroot	bitterroots
eft	efts
palmetto	palmettos
hen	henss
sheep	sheeps
godmother	godmothers
muezzin	muezzins
operagoer	operagoers
trainman	trainmen
technophobe	technophobes
jujube	jujubes
cryptanalyst	cryptanalysts
chow	chows
projectionist	projectionists
linden	lindens
prude	prudes
egomaniac	egomaniacs
placoderm	placoderms
housefly	houseflies
dingo	dingos
coati	coatis
hookworm	hookworms
curmudgeon	curmudgeons
lycaenid	lycaenids
moa	moas
toolmaker	toolmakers
puffball	puffballs
scrambler	scramblers
peafowl	peafowls
tarpon	tarpons
durian	durians
thrall	thralls
rhea	rheas
cod	cods
whisperer	whisperers
vestal	vestals
businessperson	businesspersons
cynodont	cynodonts
spendthrift	spendthrifts
slicer	slicers
hoofer	hoofers
samurai	samurais
tragopan	tragopans
chub	chubs
hypnotist	hypnotists
osteopath	osteopaths
ranter	ranters
dietician	dieticians
measurer	measurers
dill	dills
methanogen	methanogens
merganser	mergansers
firstborn	firstborns
croaker	croakers
prizefighter	prizefighters
bandsman	bandsmen
recidivist	recidivists
mauler	maulers
pompon	pompons
flatmate	flatmates
maenad	maenads
rollerblader	rollerbladers
griffon	griffons
hypochondriac	hypochondriacs
committeeman	committeemen
schnauzer	schnauzers
coneflower	coneflowers
cyclops	cyclopes
caricaturist	caricaturists
spawner	spawners
dory	dories
bear	bearss
etymologist	etymologists
parapsychologist	parapsychologists
flutist	flutists
octopus	octopi
indexer	indexers
cassowary	cassowaries
stupid	stupids
woodcarver	woodcarvers
daughter-in-law	daughters-in-law
farrier	farriers
blowfly	blowflies
cattle	cattles
alewife	alewives
half-breed	half-breeds
lass	lasses
ti	tiss
septuagenarian	septuagenarians
abalone	abalones
helmsman	helmsmen
extrovert	extroverts
featherweight	featherweights
termer	termers
etcher	etchers
beadle	beadles
affluent	affluents
budgerigar	budgerigars
empiricist	empiricists
existentialist	existentialists
duce	duces
larch	larches
changeling	changelings
hoodoo	hoodoos
annalist	annalists
salesperson	salespersons
sentimentalist	sentimentalists
loiterer	loiterers
polemicist	polemicists
foxglove	foxgloves
glassblower	glassblowers
pterodactyl	pterodactyls
postulant	postulants
proofreader	proofreaders
paranoid	paranoids
stepfather	stepfathers
rhinovirus	rhinoviruses
simpleton	simpletons
ridley	ridleys
fuchsia	fuchsias
skipjack	skipjacks
ling	lings
antbird	antbirds
blasphemer	blasphemers
segregate	segregates
lascar	lascars
smelt	smelts
dunker	dunkers
solan	solans
sedum	sedums
preceptor	preceptors
proselyte	proselytes
sundew	sundews
hajji	hajjis
naiad	naiads
embroiderer	embroiderers
monal	monals
pintail	pintails
livestock	livestocks
mallow	mallows
endive	endives
cenobite	cenobites
snorer	snorers
towhee	towhees
dynamiter	dynamiters
rustic	rustics
flagellant	flagellants
bandicoot	bandicoots
landgrave	landgraves
mailman	mailmen
proposer	proposers
meddler	meddlers
ingrate	ingrates
subshrub	subshrubs
kaffir	kaffirs
porker	porkers
ventriloquist	ventriloquists
bookbinder	bookbinders
sibyl	sibyls
geometer	geometers
growler	growlers
salp	salps
countertenor	countertenors
gib	gibs
mackerel	mackerels
chambermaid	chambermaids
counterdemonstrator	counterdemonstrators
bloodworm	bloodworms
kachina	kachinas
baya	bayas
salesclerk	salesclerks
inquirer	inquirers
sachem	sachems
masquerader	masqueraders
oleander	oleanders
shaman	shamen
stickleback	sticklebacks
ornithischian	ornithischians
dingbat	dingbats
embezzler	embezzlers
lupine	lupines
moll	molls
tippler	tipplers
whippersnapper	whippersnappers
pamphleteer	pamphleteers
violist	violists
boffin	boffins
woodlouse	woodlice
sculpin	sculpins
conjurer	conjurers
ichthyologist	ichthyologists
barmaid	barmaids
trophozoite	trophozoites
patentee	patentees
decapod	decapods
narwhal	narwhals
meadowlark	meadowlarks
agaric	agarics
longbowman	longbowmen
brakeman	brakemen
hatemonger	hatemongers
acarus	acari
all-rounder	all-rounders
auklet	auklets
hippopotamus	hippopotami
grosbeak	grosbeaks
sectarian	sectarians
gook	gooks
characin	characins
manakin	manakins
runt	runts
lactobacillus	lactobacilli
platypus	platypuses
bulimic	bulimics
gladiolus	gladioli
guan	guans
loudmouth	loudmouths
begum	begums
ascomycete	ascomycetes
cur	curs
shoveler	shovelers
croupier	croupiers
tenrec	tenrecs
goldfinch	goldfinches
myna	mynas
alcalde	alcaldes
buckskin	buckskins
defeatist	defeatists
waterfowl	waterfowls
muscleman	musclemen
titanosaur	titanosaurs
naturopath	naturopaths
ascidian	ascidians
dicot	dicots
flathead	flatheads
delphinium	delphiniums
underwing	underwings
incurable	incurables
bluejacket	bluejackets
quaestor	quaestors
palatine	palatines
concert-goer	concert-goers
monotheist	monotheists
upsetter	upsetters
tragedian	tragedians
placental	placentals
helminth	helminths
enterovirus	enteroviruses
stonefly	stoneflies
upholsterer	upholsterers
taxer	taxers
shopaholic	shopaholics
antipope	antipopes
homeopath	homeopaths
schoolfriend	schoolfriends
spirochete	spirochetes
bluegill	bluegills
gnatcatcher	gnatcatchers
darky	darkies
triumvir	triumvirs
amora	amoraim
thane	thanes
nuncio	nuncios
conformist	conformists
litchi	litchis
dowager	dowagers
guanaco	guanacos
gatecrasher	gatecrashers
goner	goners
monetarist	monetarists
cockerel	cockerels
kisser	kissers
dabbler	dabblers
revenant	revenants
fieldworker	fieldworkers
poisoner	poisoners
banksia	banksias
bowerbird	bowerbirds
right-hander	right-handers
radiographer	radiographers
toadstool	toadstools
conger	congers
metazoan	metazoans
plantlet	plantlets
trout	trouts
romper	rompers
miniaturist	miniaturists
specifier	specifiers
assignee	assignees
stamper	stampers
handmaid	handmaids
dry	drys
sorrel	sorrels
cercaria	cercariae
riveter	riveters
flagellate	flagellates
sawfly	sawflies
dromaeosaur	dromaeosaurs
exegete	exegetes
trier	triers
ironmonger	ironmongers
allocator	allocators
malik	maliks
gilder	gilders
kibbutznik	kibbutzniks
lapdog	lapdogs
fisherman	fishermans
sorceress	sorceresses
tardigrade	tardigrades
pollard	pollards
prebendary	prebendaries
depressive	depressives
batman	batmen
paperboy	paperboys
cosmetologist	cosmetologists
enchanter	enchanters
taskmaster	taskmasters
standee	standees
nutter	nutters
caribou	caribous
wether	wethers
countess	countesses
territorial	territorials
legatee	legatees
helpmate	helpmates
procurer	procurers
ragamuffin	ragamuffins
achillea	achilleas
canonist	canonists
fakir	fakirs
lavender	lavenders
pomelo	pomelos
myrmidon	myrmidons
servitor	servitors
dribbler	dribblers
tosser	tossers
eider	eiders
sapsucker	sapsuckers
massager	massagers
barilla	barillas
caladium	caladiums
ornithopod	ornithopods
reciter	reciters
compositor	compositors
moorhen	moorhens
subaltern	subalterns
yanker	yankers
basidiomycete	basidiomycetes
conodont	conodonts
curassow	curassows
stacker	stackers
parr	parrs
nitpicker	nitpickers
usurer	usurers
scorekeeper	scorekeepers
razorbill	razorbills
billy	billies
mongoloid	mongoloids
toff	toffs
lithographer	lithographers
mandrill	mandrills
transcriber	transcribers
foremother	foremothers
transferee	transferees
lector	lectors
chimaera	chimaeras
doorkeeper	doorkeepers
frogmouth	frogmouths
cheapskate	cheapskates
moonlighter	moonlighters
lather	lathers
briber	bribers
popularizer	popularizers
bollworm	bollworms
yucca	yuccas
submitter	submitters
spitter	spitters
abettor	abettors
cyprinid	cyprinids
sister-in-law	sisters-in-law
insured	insureds
homunculus	homunculi
chachalaca	chachalacas
endoparasite	endoparasites
kibitzer	kibitzers
oboist	oboists
wheelwright	wheelwrights
neurobiologist	neurobiologists
wort	worts
wicket-keeper	wicket-keepers
pothead	potheads
twitterer	twitterers
ordinand	ordinands
dicynodont	dicynodonts
walleye	walleyes
sandbagger	sandbaggers
ranker	rankers
savory	savories
adelgid	adelgids
plainclothesman	plainclothesmen
macroeconomist	macroeconomists
subdeacon	subdeacons
romanticist	romanticists
diapsid	diapsids
ignoramus	ignoramuses
currawong	currawongs
broadbill	broadbills
jawan	jawans
sporophyte	sporophytes
songster	songsters
columbine	columbines
blackwood	blackwoods
honeycreeper	honeycreepers
packhorse	packhorses
calypso	calypsos
relict	relicts
protegee	protegees
reprobate	reprobates
aquanaut	aquanauts
tomboy	tomboys
party	partys
contester	contesters
horsefly	horseflies
embryologist	embryologists
sunray	sunrays
pronghorn	pronghorns
tattletale	tattletales
hellhound	hellhounds
genet	genets
nondescript	nondescripts
monolingual	monolinguals
bullhead	bullheads
dimwit	dimwits
asshole	assholes
anthropoid	anthropoids
elver	elvers
hedger	hedgers
fantasist	fantasists
armyworm	armyworms
colleen	colleens
longan	longans
sylph	sylphs
pawpaw	pawpaws
misogynist	misogynists
perjurer	perjurers
stylite	stylites
ankylosaur	ankylosaurs
trusty	trusties
highbrow	highbrows
coxswain	coxswains
cataloger	catalogers
honeypot	honeypots
diplomate	diplomates
lappet	lappets
stockist	stockists
conversationalist	conversationalists
pontifex	pontifices
scoter	scoters
merino	merinos
poon	poons
trillium	trilliums
stabber	stabbers
geoduck	geoducks
slapper	slappers
bilberry	bilberries
eurypterid	eurypterids
myriapod	myriapods
thornbill	thornbills
wog	wogs
falangist	falangists
fellah	fellahin
basil	basils
bandit	banditti
hornwort	hornworts
dhole	dholes
baobab	baobabs
lawgiver	lawgivers
ascender	ascenders
chela	chelae
cybernaut	cybernauts
bibliographer	bibliographers
rani	ranis
bacteriologist	bacteriologists
utilitarian	utilitarians
officiant	officiants
mother-in-law	mothers-in-law
ovenbird	ovenbirds
rotavirus	rotaviruses
mangabey	mangabeys
mistletoe	mistletoes
moray	morays
muncher	munchers
wrack	wracks
overnighter	overnighters
heterotroph	heterotrophs
ornithomimid	ornithomimids
splicer	splicers
cornflower	cornflowers
burgomaster	burgomasters
lyrebird	lyrebirds
boatbuilder	boatbuilders
megalomaniac	megalomaniacs
honker	honkers
miro	miros
coppersmith	coppersmiths
consignee	consignees
cutworm	cutworms
pteridophyte	pteridophytes
cygnet	cygnets
malingerer	malingerers
baster	basters
malamute	malamutes
butternut	butternuts
stitcher	stitchers
supernumerary	supernumeraries
moppet	moppets
bellboy	bellboys
polypore	polypores
bagman	bagmen
swiftlet	swiftlets
compromiser	compromisers
bovid	bovids
labyrinthodont	labyrinthodonts
zucchini	zucchinis
epicure	epicures
proconsul	proconsuls
stegosaur	stegosaurs
gee-gee	gee-gees
quahog	quahogs
cuckold	cuckolds
rheumatologist	rheumatologists
turtledove	turtledoves
tigress	tigresses
balletomane	balletomanes
plowman	ploughmen
pipefish	pipefishes
spoilsport	spoilsports
redbud	redbuds
anathema	anathemas
basset	bassets
conciliator	conciliators
mariposa	mariposas
diagnostician	diagnosticians
schistosome	schistosomes
hornbeam	hornbeams
squaw	squaws
vulgarian	vulgarians
sockeye	sockeyes
dauphin	dauphins
sangoma	sangomas
fucker	fuckers
milkweed	milkweeds
rye	ryes
intervenor	intervenors
radiolarian	radiolarians
pelycosaur	pelycosaurs
yarrow	yarrows
gaur	gaurs
barnburner	barnburners
gaffer	gaffers
descender	descenders
liger	ligers
pinworm	pinworms
papillon	papillons
scoffer	scoffers
blackcap	blackcaps
gasbag	gasbags
wahoo	wahoos
galago	galagos
philodendron	philodendrons
goral	gorals
kea	keas
indigo	indigos
beetroot	beetroots
erotic	erotics
payee	payees
gentleman-at-arms	gentlemen-at-arms
ritualist	ritualists
shelduck	shelducks
chef	cheves
leveler	levelers
gofer	gofers
steeplechaser	steeplechasers
partaker	partakers
seducer	seducers
ibex	ibexes
mugwump	mugwumps
major-general	major-generals
bungler	bunglers
actinomycete	actinomycetes
rorqual	rorquals
pedant	pedants
hagiographer	hagiographers
fescue	fescues
rotter	rotters
jilt	jilts
stocker	stockers
mammalogist	mammalogists
annihilator	annihilators
lepidopterist	lepidopterists
flyweight	flyweights
numerologist	numerologists
ringmaster	ringmasters
carbineer	carbineers
escapist	escapists
nonreader	nonreaders
doyenne	doyennes
burgrave	burgraves
wiggler	wigglers
krait	kraits
nibbler	nibblers
jerboa	jerboas
articulator	articulators
tare	tares
commensal	commensals
olm	olms
neoliberal	neoliberals
madame	mesdames
standard-bearer	standard-bearers
bantamweight	bantamweights
walk-on	walk-ons
halfbeak	halfbeaks
lory	lories
nightshade	nightshades
basilisk	basilisks
fungus	funguses
hominoid	hominoids
parodist	parodists
ganger	gangers
votary	votaries
solitaire	solitaires
goose	gooses
bobby	bobbys
nonstarter	nonstarters
acoustician	acousticians
narcoleptic	narcoleptics
pneumococcus	pneumococci
supremo	supremos
mezzo-soprano	mezzo-sopranos
abstractionist	abstractionists
plagiarist	plagiarists
kneeler	kneelers
carabao	carabaos
geomancer	geomancers
potholer	potholers
ethologist	ethologists
footpad	footpads
curandero	curanderos
cauliflower	cauliflowers
lily	lilys
thatcher	thatchers
bunkmate	bunkmates
sponger	spongers
squab	squabs
armorer	armorers
pony	ponys
steamfitter	steamfitters
pinko	pinkos
tamandua	tamanduas
agouti	agoutis
flatterer	flatterers
shepherdess	shepherdesses
rhymer	rhymers
fisherman	fishermens
naif	naifs
functionalist	functionalists
shipworm	shipworms
cavy	cavies
part-timer	part-timers
caltrop	caltrops
gorgonian	gorgonians
elapid	elapids
tabby	tabbies
annuitant	annuitants
graphologist	graphologists
zany	zanies
nonparticipant	nonparticipants
narc	narcs
macadamia	macadamias
pear	pearses
gitano	gitanos
dauber	daubers
plainsman	plainsmen
bowhead	bowheads
odalisque	odalisques
mahatma	mahatmas
witness	witnessess
proturan	proturans
linnet	linnets
sheller	shellers
beloved	beloveds
bootmaker	bootmakers
whooper	whoopers
hakim	hakims
shuffler	shufflers
cholla	chollas
unilateralist	unilateralists
polymath	polymaths
encyclopedist	encyclopedists
sabra	sabras
eulogist	eulogists
sketcher	sketchers
seeder	seeders
mafioso	mafiosos
porgy	porgies
differentiator	differentiators
wingback	wingbacks
harmonizer	harmonizers
thyme	thymes
calabash	calabashes
mangosteen	mangosteens
nincompoop	nincompoops
oryx	oryxes
syndic	syndics
bacchant	bacchantes
remount	remounts
liturgist	liturgists
pyromaniac	pyromaniacs
reeler	reelers
smiler	smilers
foundress	foundresses
plodder	plodders
shyster	shysters
groaner	groaners
tablemate	tablemates
lighterman	lightermen
falsifier	falsifiers
cyberpunk	cyberpunks
gnu	gnus
viroid	viroids
hematologist	hematologists
grouch	grouches
motmot	motmots
hawk	hawkses
anchorite	anchorites
pachycephalosaur	pachycephalosaurs
office-bearer	office-bearers
mudskipper	mudskippers
revenuer	revenuers
napu	napus
cryptogam	cryptogams
oligochaete	oligochaetes
okapi	okapis
cunt	cunts
comedienne	comediennes
fritillary	fritillaries
yogi	yogin
springer	springers
greenskeeper	greenskeepers
grunter	grunters
compulsive	compulsives
pullet	pullets
oviraptorid	oviraptorids
liveryman	liverymen
melter	melters
forty-niner	forty-niners
capon	capons
agnate	agnates
vestryman	vestrymen
gunnel	gunnels
bougainvillea	bougainvilleas
phrenologist	phrenologists
pedaler	pedalers
butch	butches
mammy	mammies
currier	curriers
testee	testees
proboscidean	proboscideans
ginkgo	ginkgos
firebug	firebugs
crappie	crappies
namer	namers
cinquefoil	cinquefoils
barberry	barberries
chatterer	chatterers
fatalist	fatalists
wallah	wallahs
emmer	emmers
convalescent	convalescents
housemaster	housemasters
bennet	bennets
cartwright	cartwrights
lumper	lumpers
rowan	rowans
butcherbird	butcherbirds
jacamar	jacamars
albacore	albacores
grantor	grantors
ace	acess
cardoon	cardoons
littleneck	littlenecks
compere	comperes
laugher	laughers
ramrod	ramrods
pluralist	pluralists
axolotl	axolotls
staghound	staghounds
co-ed	co-eds
redstart	redstarts
licenser	licensers
signaler	signalers
misanthrope	misanthropes
soprano	soprani
panderer	panderers
everyman	everymen
banyan	banyans
flamen	flamines
sailmaker	sailmakers
syncopator	syncopators
serval	servals
appreciator	appreciators
newswoman	newswomen
bigamist	bigamists
lamplighter	lamplighters
kleptomaniac	kleptomaniacs
mesquite	mesquites
sociobiologist	sociobiologists
arbovirus	arboviruses
drudge	drudges
praya	prayas
viticulturist	viticulturists
womanizer	womanizers
solenogaster	solenogasters
