sulfa	antibacterial
mixologist	employee
smegma	sebum
mineralogist	scientist
rickettsia	eubacteria
grindstone	sharpener
overstress	overstate
mere	pond
steersman	mariner
paleogeography	archeology
fantasist	creator
underclassman	undergraduate
abrogate	abolish
malmsey	madeira
carissa	shrub
diverticulum	hernia
exoticism	foreignness
spendthrift	prodigal
aplomb	composure
draper	trader
phosphorescence	fluorescence
bivalve	mollusk
cycad	gymnosperm
ale	beer
troubadour	singer
lhasa	terrier
spaceman	traveler
acetaminophen	analgesic
foundry	factory
zimbabwean	african
shareowner	investor
porterhouse	beefsteak
darvon	analgesic
listener	perceiver
adrenalin	vasoconstrictor
wisent	bison
pediment	gable
cellulose	polysaccharide
few	elite
vibrio	eubacteria
secretase	enzyme
appellant	litigant
calamagrostis	gramineae
paleoclimatology	archeology
burton	ale
smithy	workplace
ephedrine	bronchodilator
drambuie	liqueur
pratincole	shorebird
teton	sioux
czechoslovak	european
hakeem	muslim
nitwit	simpleton
shiitake	fungus
deceitfulness	disingenuousness
kine	bovine
hohenzollern	dynasty
mexicano	mexican
adjacency	nearness
proteome	protein
herbivore	animal
tsh	hormone
hottentot	khoisan
hangman	executioner
rector	clergyman
chanal	shrub
malian	african
airliner	airplane
avenged	punish
pickpocket	thief
pedicab	tricycle
melatonin	hormone
chlorella	alga
leatherneck	serviceman
barite	mineral
heliport	airport
adelie	penguin
cymbidium	orchid
dork	misfit
folklore	lore
bootlegger	criminal
crudites	appetizer
erotic	sensualist
roustabout	mariner
liposome	vesicle
stridency	timbre
buddleia	shrub
humourist	entertainer
contra	nicaraguan
policeman	lawman
shirtwaist	blouse
aerodrome	airfield
bobby	policeman
pronghorn	ruminant
bart	aristocrat
troubleshooter	repairman
enforcer	assistant
svengali	persuader
pavonia	shrub
groundbreaker	originator
coxsackievirus	enterovirus
rodent	placental
saturday	weekday
gemsbok	oryx
gunrunner	smuggler
fibreboard	wallboard
codeine	opiate
coadjutor	assistant
comply	obey
methotrexate	immunosuppressant
savior	benefactor
evasiveness	untruthfulness
collins	highball
phenolphthalein	laxative
wizardry	creativity
academic	educator
althaea	mallow
playschool	preschool
adrenalin	hormone
pigman	herder
catechin	tannin
phenobarbital	barbiturate
contiguity	nearness
astrologist	forecaster
amphibole	mineral
villager	inhabitant
goddaughter	godchild
medroxyprogesterone	progestin
compatriot	national
bedstead	furniture
dermatomyositis	myositis
sectional	furniture
psilocybin	hallucinogen
frenchman	european
cargo	merchandise
glucosamine	glucose
rectangle	parallelogram
grocer	merchant
hypoplasia	dysplasia
sculptor	artist
nicotine	alkaloid
lye	caustic
speakeasy	barroom
hotshot	expert
hatred	emotion
antivenin	antitoxin
hindi	sanskrit
duelist	adversary
oogenesis	gametogenesis
extravaganza	entertainment
hayfield	grassland
stanhopea	orchid
archdiocese	diocese
subdeacon	clergyman
hysteric	neurotic
taxman	bureaucrat
cablegram	telegram
ada	enzyme
irredentism	doctrine
daffodil	narcissus
silents	movie
voter	citizen
moa	ratite
rustic	commoner
nordic	germanic
dinnertime	mealtime
emancipator	liberator
illustrator	artist
longlegs	shorebird
sooth	truthfulness
panty	underpants
calloused	inure
triamcinolone	corticosteroid
futon	mattress
churchman	clergyman
abridgement	summary
laelia	orchid
tricker	troublemaker
borzoi	wolfhound
arminian	disciple
nightrider	attacker
plugboard	central
chrysotile	asbestos
innovator	originator
maidservant	domestic
kerosene	hydrocarbon
cuboid	parallelepiped
rankle	annoy
madrona	arbutus
clinician	practitioner
astatine	halogen
edelweiss	wildflower
panadol	analgesic
archaeology	anthropology
barbu	threadfin
middy	blouse
easterner	inhabitant
malathion	insecticide
cartographer	geographer
physiologist	biologist
marc	brandy
brewpub	brewery
proteomics	genetics
donjon	stronghold
klutz	stupid
codeine	analgesic
logistician	expert
furfural	aldehyde
phosphoprotein	protein
knucklehead	stupid
illegality	unlawfulness
dampness	wetness
pedophilia	paraphilia
formalization	systematization
harijan	outcast
calvinism	protestantism
bagel	bun
intricacy	complexity
skater	athlete
pseudo	deceiver
pertinence	relevance
sheraton	furniture
menhir	megalith
avenge	punish
negotiator	communicator
victrola	gramophone
fishmonger	trader
hydrologist	geologist
typist	employee
mina	starling
gloxinia	houseplant
switchboard	central
hcg	gonadotropin
concision	terseness
cottier	serf
norseman	european
newsagent	shopkeeper
sandpiper	shorebird
puffery	flattery
muckraker	detractor
autobahn	expressway
liao	dynasty
malign	defame
pachuco	adolescent
estradiol	estrogen
enteropathy	disease
telemetry	measurement
triggerman	murderer
townes	physicist
prednisolone	glucocorticoid
scammer	deceiver
cholesterol	sterol
dilaudid	analgesic
spirochete	eubacteria
alprazolam	benzodiazepine
gangster	criminal
mobster	criminal
malaprop	misstatement
hellene	european
curator	custodian
bracero	laborer
spacewalker	astronaut
eutherian	mammal
millipede	arthropod
selenium	antioxidant
audiology	otology
diamondback	rattlesnake
veldt	grassland
furze	shrub
brioche	bun
toxoid	antigen
novocaine	procaine
tirade	denunciation
lab	workplace
advertiser	publicist
infomercial	commercial
rhomb	parallelogram
doxorubicin	antibiotic
paleography	archeology
foursquare	rectangle
murine	rodent
hamster	rodent
liar	deceiver
asthenia	infirmity
neurosurgeon	surgeon
bacillus	eubacteria
omeprazole	antacid
leptospirosis	zoonosis
thiopental	barbiturate
tyrannosaurus	theropod
eurasian	european
dunlin	sandpiper
wildebeest	antelope
chlorofluorocarbon	fluorocarbon
schnauzer	terrier
tamarin	marmoset
underwear	undergarment
rotavirus	reovirus
schoolboy	schoolchild
heckler	troublemaker
mollusc	invertebrate
seljuk	dynasty
rotifer	invertebrate
carriageway	roadway
extortionist	criminal
auk	seabird
stickiness	viscosity
lysosome	organelle
durability	permanence
electrolytic	capacitor
arsonist	criminal
pachysandra	subshrub
msh	hormone
songwriter	composer
yugoslav	european
slavey	domestic
palaeobiology	paleontology
ghat	stairway
philippic	denunciation
marsh	wetland
farmer	creator
ilmenite	mineral
wollastonite	mineral
imposter	deceiver
stockman	farmer
monoxide	oxide
penetrator	intruder
hoodlum	criminal
codeine	antitussive
lindane	insecticide
corticotropin	hormone
valor	courage
intermediary	negotiator
dexamethasone	corticosteroid
monosaccharide	carbohydrate
leftist	socialist
ddt	insecticide
blini	pancake
feasibility	practicability
irresponsibility	untrustworthiness
suppertime	mealtime
serbian	slav
philanderer	libertine
quicklime	oxide
angevin	frenchman
syndicator	businessman
pasteboard	cardboard
ascomycete	fungus
carpetbagger	opportunist
archeologist	anthropologist
liverwort	bryophyte
superstar	expert
physostigmine	alkaloid
seismology	geophysics
propagandist	communicator
cassock	vestment
scofflaw	criminal
jailor	lawman
monasticism	austerity
brakeman	trainman
sirocco	windstorm
spermatozoon	gamete
beltway	highway
mezcal	cactus
reporter	communicator
weirdness	unfamiliarity
canape	appetizer
disillusionment	edification
ironmongery	merchandise
lothario	womanizer
homeroom	classroom
eavesdropper	hearer
sophism	fallacy
paratroops	infantry
sightseer	tourist
hiker	pedestrian
cameraman	photographer
beninese	african
wainwright	wright
monastic	religious
recrudescence	outbreak
visualizer	perceiver
octagon	polygon
nutria	rodent
latke	pancake
winery	distillery
swampland	wetland
zebra	equine
orthoclase	feldspar
lunchtime	mealtime
androgyne	bisexual
paramecium	ciliate
carrack	galleon
tetrahedron	polyhedron
ashkenazi	jew
resoluteness	trait
flavin	ketone
microscopist	scientist
luminal	barbiturate
chaplain	clergyman
hedonist	sensualist
omentum	peritoneum
indiana	artist
rani	aristocrat
hyperbole	trope
surplice	vestment
finagle	achieve
recliner	armchair
subjectivist	intellectual
eubacteria	bacteria
egocentrism	trait
airbus	airliner
expressionist	artist
angevine	frenchman
carnelian	chalcedony
nandrolone	androgen
fluor	mineral
penicillin	antibiotic
endonuclease	nuclease
timorese	asian
rabies	zoonosis
yid	jew
compote	dessert
babka	coffeecake
awol	absentee
carotenoid	antioxidant
paraphernalia	equipment
minicab	minicar
cravat	neckwear
patisserie	bakery
sesquicentennial	anniversary
polyelectrolyte	electrolyte
florilegium	anthology
atavism	recurrence
paucity	scarcity
marketer	merchant
bauxite	mineral
gerbil	rodent
napa	crucifer
benefactress	benefactor
fentanyl	opiate
arsehole	anus
woodchuck	marmot
guayule	subshrub
bonobo	chimpanzee
silverware	tableware
kaolinite	mineral
nephew	kinsman
epicure	sensualist
milfoil	achillea
welshman	european
polluted	dirty
pavlova	dessert
stripling	juvenile
proteinase	enzyme
senna	shrub
epigraphy	paleography
belorussian	european
canonisation	sanctification
savannah	grassland
stockcar	boxcar
submariner	bluejacket
hypnotize	sedate
halite	mineral
germander	subshrub
diatribe	denunciation
dodecahedron	polyhedron
newswoman	reporter
angolan	african
cpr	resuscitation
wednesday	weekday
quatrain	stanza
pastureland	grassland
dexterity	adeptness
cameroonian	african
chloramine	antiseptic
cybercafe	cafe
saleswoman	salesperson
chlorhexidine	antiseptic
nucleotide	ester
clomipramine	tricyclic
upbraid	accuse
disseminator	communicator
agouti	rodent
guestworker	workman
arb	businessman
storehouse	depository
suffragette	suffragist
ribavirin	antiviral
grenadine	syrup
exotoxin	toxin
nandu	ratite
cowry	gastropod
earthstar	fungus
sportsman	athlete
antioxidant	inhibitor
druidism	paganism
flan	dessert
arthroscope	endoscope
lutein	carotenoid
monkshood	aconite
walkaway	victory
hijinks	merrymaking
inoculation	immunization
streptococcus	eubacteria
recluse	loner
calamari	seafood
thimerosal	antiseptic
metronidazole	antiprotozoal
plainsman	inhabitant
verticillium	fungus
draftee	serviceman
pimple	acne
playboy	hedonist
foodie	sensualist
asbestos	amphibole
oast	kiln
trappist	monk
burberry	raincoat
deer	ruminant
godliness	piety
flaxseed	oilseed
schoolmarm	schoolteacher
easel	tripod
janitor	custodian
frisbee	plaything
paresis	paralysis
synecdoche	trope
clairvoyant	psychic
galactose	sucrose
meteorite	meteoroid
cleric	clergyman
meccano	plaything
einstein	intellectual
joyfulness	emotion
idolize	adore
scatterbrain	simpleton
codify	systematize
atropine	antispasmodic
hemangioma	angioma
sephardi	jew
sobriquet	appellation
ade	beverage
papain	enzyme
mulla	muslim
assuredness	composure
reptile	vertebrate
perpetuity	permanence
gotterdammerung	myth
lem	spacecraft
bangladeshi	asian
owlet	owl
bookkeeping	accountancy
psychoanalyst	psychiatrist
firethorn	shrub
schlock	merchandise
echinoderm	invertebrate
interregnum	interim
defamer	detractor
renin	protease
photometry	measurement
supplier	businessperson
racist	bigot
torero	bullfighter
troller	fisherman
haiku	poem
tearoom	restaurant
charon	ferryman
tec	policeman
rampart	embankment
primaquine	antimalarial
telomerase	enzyme
iguanodon	dinosaur
bryozoan	invertebrate
agriculturalist	farmer
gondolier	boatman
physicist	scientist
nagari	syllabary
pureblood	animal
witchery	sorcery
madagascan	african
cactus	succulent
clostridium	eubacteria
mountie	policeman
ventolin	bronchodilator
physiography	geography
etcher	artist
limonene	terpene
screwup	mismanagement
parolee	criminal
primatology	mammalogy
stilton	bleu
flowerpot	container
transferrin	globulin
transaminase	transferase
shebeen	tavern
larkspur	delphinium
mucin	glycoprotein
electroshock	electrotherapy
chlorine	halogen
shanny	blenny
carpel	pistil
lutheran	disciple
ethylene	alkene
le	lupus
centrosome	cytoplasm
lombard	european
archduchess	princess
bling	jewelry
borstal	reformatory
amphotericin	antibiotic
mujahid	muslim
plantagenet	dynasty
tanzanian	african
hawthorn	shrub
coconspirator	criminal
ethnology	anthropology
spleenwort	fern
millwright	wright
garnet	mineral
prescribed	inflict
adventurism	recklessness
kiln	furnace
goddess	deity
cymric	brythonic
pleuropneumonia	pneumonia
jongleur	singer
isinglass	mineral
albinism	hypopigmentation
artiste	performer
goldfish	cyprinid
scid	immunodeficiency
amish	mennonite
rosebush	shrub
syncytium	cytoplasm
byname	appellation
dextrin	polysaccharide
tricyclic	antidepressant
pawnbroker	lender
turnkey	lawman
elavil	tricyclic
ploughman	farmhand
waffler	communicator
galena	mineral
lcm	multiple
cottonseed	oilseed
anthill	knoll
cosmetic	toiletry
polypore	basidiomycete
olympian	athlete
synopsis	summary
hirer	employer
mac	raincoat
nembutal	barbiturate
defector	wrongdoer
budgie	parakeet
rustler	thief
dale	valley
moll	criminal
tadpole	larva
taoist	disciple
forester	farmer
autoloader	firearm
disaccharide	oligosaccharide
legionella	bacteria
presidio	fortress
overbite	malocclusion
hapsburg	dynasty
tidbit	dainty
arietta	aria
detainee	prisoner
bedouin	nomad
cheops	pharaoh
suffragette	feminist
atherosclerosis	arteriosclerosis
bisexual	sensualist
phototropism	tropism
miser	hoarder
mineralogy	geology
gravedigger	laborer
diethylstilbestrol	estrogen
sard	chalcedony
mollusk	invertebrate
siskin	finch
althea	mallow
totalitarian	disciple
antibody	protein
rhododendron	shrub
narcolepsy	hypersomnia
transmittance	coefficient
immunogen	antigen
healthfulness	wholesomeness
stirk	cattle
plowman	farmhand
therapist	expert
hellion	troublemaker
hick	rustic
yob	attacker
epicurean	sensualist
cartel	consortium
lumberman	laborer
gramicidin	antiseptic
unitarian	disciple
enchanter	sorcerer
obturator	prosthesis
amyloidosis	illness
decidua	epithelium
demerol	narcotic
petty	larceny
loblolly	gruel
monetize	legalize
fungible	commodity
glume	bract
kleptomaniac	appropriator
frenchwoman	european
packman	seller
tuesday	weekday
manzanilla	sherry
dementia	insanity
carolingian	sovereign
snobbishness	arrogance
geomancer	diviner
ragamuffin	urchin
skein	hank
nitrogenase	enzyme
warhead	explosive
iodide	halide
pahoehoe	lava
goy	christian
flint	silica
rondel	poem
chasuble	vestment
dicot	angiosperm
animatronics	robotics
formaldehyde	aldehyde
literalness	concreteness
surrealist	artist
envoi	stanza
mack	raincoat
transgressor	wrongdoer
rube	rustic
sackbut	trombone
paymaster	payer
burgess	englishman
misapprehension	misconception
blah	grandiosity
paranoid	psychotic
carborundum	abrasive
bookman	intellectual
schizophrenia	psychosis
hooligan	attacker
talkie	movie
deodorant	toiletry
nystatin	antibiotic
farrier	blacksmith
insurability	eligibility
diphenhydramine	antihistamine
adenocarcinoma	carcinoma
great	achiever
indri	lemur
oxygenase	oxidoreductase
handbill	ad
azurite	malachite
circe	sorceress
milkman	deliveryman
somalian	african
instar	arthropod
smoothbore	firearm
piety	righteousness
nightie	lingerie
evildoer	wrongdoer
nightbird	individualist
abracadabra	gibberish
huarache	sandal
rectitude	righteousness
prescribe	inflict
servility	submissiveness
skag	heroin
wildflower	angiosperm
shina	dard
bedsit	apartment
coffeehouse	restaurant
wesleyan	methodist
citizen	national
julep	highball
cartwright	wright
igd	immunoglobulin
poetess	poet
endorphin	peptide
osmund	fern
bravura	virtuosity
clonidine	antihypertensive
conchology	malacology
urokinase	protease
cattle	bovine
stevedore	laborer
augustinian	friar
austrian	european
sherpa	asian
boudoir	bedroom
veranda	porch
elastase	enzyme
whitetail	deer
battlement	rampart
firecracker	firework
thumbnail	fingernail
warfarin	anticoagulant
unreliability	irresponsibility
undergrad	collegian
sambuca	liqueur
chessboard	checkerboard
cytokine	protein
luxemburger	european
behaviourist	psychologist
honeypot	protea
archeology	anthropology
noncombatant	serviceman
nudist	individualist
salesgirl	salesperson
cerussite	mineral
sonatina	sonata
dbms	software
phenacetin	analgesic
neurotoxin	toxin
kazakhstani	asian
constructivist	artist
profanity	utterance
peshmerga	kurd
virologist	microbiologist
ileus	enteropathy
chapeau	headdress
styrax	shrub
vancomycin	antibiotic
derogate	disparage
tetrahymena	ciliate
serin	finch
manicurist	beautician
dna	polymer
grandma	grandparent
nurseryman	horticulturist
volcanology	geophysics
hn	hydride
ethiopian	african
meanie	oppressor
magnate	businessman
workman	employee
astrologer	forecaster
reactant	chemical
mavin	expert
airstrip	airfield
myelofibrosis	fibrosis
savanna	grassland
avocet	shorebird
antiquarian	expert
barrister	lawyer
leptospira	spirochete
catsup	condiment
veracity	truthfulness
tusker	mammal
da	prosecutor
fishery	workplace
rudd	cyprinid
ambidexterity	handedness
butadiene	hydrocarbon
newsboy	deliveryman
aplasia	dysplasia
dilemma	perplexity
sth	hormone
lebanese	asian
ming	dynasty
matabele	nguni
scrivener	employee
nobody	commoner
faience	earthenware
aspirant	applicant
rapeseed	oilseed
amaretto	liqueur
recce	reconnaissance
dreck	merchandise
honeymooner	spouse
belgian	european
glucophage	antidiabetic
diplegia	paralysis
researcher	scientist
spammer	sender
canonization	sanctification
exclusiveness	snobbery
inn	hotel
cytogenetics	genetics
hypocrite	deceiver
monoplane	airplane
chophouse	restaurant
unreason	insanity
nullah	valley
slater	isopod
pesticide	chemical
whitethorn	hawthorn
disgorgement	reflex
acrolein	aldehyde
sweatshirt	pullover
underrate	misjudge
wahabi	muslim
enkephalin	endorphin
jailer	lawman
jordanian	asian
explosive	chemical
neuroscientist	neurobiologist
glanders	zoonosis
dreadnought	battleship
coiffeur	hairdresser
amhara	ethiopian
expounder	intellectual
hypermedia	multimedia
hepatic	bryophyte
chignon	hairdo
immortelle	everlasting
chadian	african
organdy	muslin
adrenergic	vasoconstrictor
fogy	oldster
psa	protein
valium	benzodiazepine
limey	englishman
emeritus	retiree
colander	strainer
weightlifter	athlete
abuser	wrongdoer
callous	inure
bathymetry	measurement
glucosamine	amino
disloyalty	infidelity
jingo	patriot
snobbery	arrogance
impala	antelope
antipsychotic	tranquilizer
neuroleptic	tranquilizer
whipper	oppressor
thorazine	phenothiazine
meningioma	tumor
shanghai	kidnap
earthling	inhabitant
oceanographer	scientist
marasmus	malnutrition
drummer	percussionist
turp	resection
aussie	inhabitant
countersuit	lawsuit
matador	bullfighter
conciseness	terseness
idolised	adore
neuropsychology	psychology
shotgun	firearm
broncho	mustang
sculptress	sculptor
trustworthiness	trait
curlew	shorebird
gabonese	african
hearer	perceiver
grandparent	forebear
delinquent	wrongdoer
menorrhagia	menstruation
gasohol	hydrocarbon
pope	catholic
platitude	truism
biophysicist	physicist
tights	hosiery
freethinking	doctrine
mesa	tableland
mesentery	peritoneum
masonite	fiberboard
allosaurus	theropod
neosporin	antibacterial
skybox	stadium
nincompoop	simpleton
persecution	maltreatment
grappa	brandy
bedspread	bedclothes
visitor	traveler
grandmother	grandparent
stomper	pedestrian
wren	passerine
odalisque	concubine
jessamine	jasmine
accountant	businessperson
swashbuckling	demeanor
chronicler	historian
peter	penis
carrell	alcove
bhutanese	asian
shipwright	wright
ahem	utterance
spaceship	spacecraft
copyist	employee
agate	chalcedony
housemaster	headmaster
heroism	courage
counterrevolutionary	revolutionist
artist	creator
lh	gonadotropin
tetracycline	antibacterial
hatmaker	merchant
cittern	guitar
pectin	cellulose
norepinephrine	vasoconstrictor
tightwad	miser
sheikha	wife
lecithin	emulsifier
enterobacteria	eubacteria
alb	vestment
periodontitis	disease
brule	teton
sonority	timbre
huguenot	calvinist
warehouseman	workman
bitterroot	wildflower
dualism	doctrine
pembroke	corgi
metazoan	animal
bearcat	civet
foreperson	juror
potion	beverage
curate	clergyman
bilby	bandicoot
eritrean	ethiopian
humanitarianism	doctrine
mugwort	wormwood
overstay	bide
instrumentalist	performer
dishware	tableware
kangaroo	marsupial
pud	dessert
ngu	urethritis
naturopath	therapist
vaquita	porpoise
avenger	attacker
humorist	entertainer
pentose	monosaccharide
stepdaughter	stepchild
uracil	nucleotide
ornithologist	zoologist
silicone	siloxane
sociopath	neurotic
anion	ion
helianthemum	shrub
pharmacogenetics	genetics
saxitoxin	neurotoxin
inexperience	ignorance
caracal	lynx
malachite	mineral
yea	affirmative
loudmouth	troublemaker
woodcock	shorebird
jubilee	anniversary
rocephin	cephalosporin
catecholamine	hormone
skirmisher	combatant
actinolite	amphibole
yellowlegs	sandpiper
idolized	adore
ineffectiveness	powerlessness
bowman	expert
cyperus	cyperaceae
aunt	kinswoman
aromatherapy	therapy
ig	antibody
lunchroom	restaurant
geebung	shrub
trinidadian	inhabitant
cashbox	strongbox
rooibos	shrub
lorazepam	benzodiazepine
plasminogen	plasmin
gendarme	policeman
fluorite	mineral
astrodynamics	astronomy
vender	merchant
homophone	homonym
freebooter	thief
devanagari	syllabary
sweetpea	vine
verdin	titmouse
zit	acne
museum	depository
rhombus	parallelogram
genealogist	expert
sycophant	flatterer
hypnotised	sedate
reaffirmation	avowal
dimwit	simpleton
tench	cyprinid
meadow	grassland
fenestra	orifice
coronary	thrombosis
barmaid	bartender
gambian	african
linearity	dimensionality
metaphor	trope
collagenase	enzyme
bigamist	spouse
assyriology	archeology
ecologist	biologist
tetroxide	oxide
disfranchisement	discontinuance
gaba	neurotransmitter
menshevik	socialist
sle	lupus
emigrant	migrant
yes	affirmative
prevaricate	misinform
chert	silica
kinase	enzyme
ubiquinone	coenzyme
internee	prisoner
rolaids	antacid
quadrilateral	polygon
itinerant	laborer
courier	traveler
twerp	simpleton
expressway	highway
shoplifter	thief
sapsucker	woodpecker
meson	boson
pitman	miner
jesuit	religious
abridgment	summary
kerosine	hydrocarbon
indispensability	essentiality
sensitizer	activator
policyholder	customer
mathematician	scientist
mugger	robber
neurosyphilis	syphilis
atopy	allergy
nightgown	lingerie
tractability	trait
musher	traveler
centennial	anniversary
blackbuck	antelope
togolese	african
thymidine	nucleoside
customer	consumer
bonehead	stupid
dockyard	waterfront
hanuman	langur
dumas	legislature
protea	shrub
ricin	albumin
permissibility	admissibility
patroller	watchman
crocked	dirty
fusilier	infantryman
reproducibility	dependability
trichloroethane	ethylene
derris	shrub
colostomy	ostomy
caladenia	orchid
scotsman	european
albuterol	bronchodilator
cretinism	hypothyroidism
osteoarthritis	arthritis
congressman	legislator
realness	actuality
zionist	jew
autostrada	expressway
bolivia	canasta
prowler	intruder
sangoma	therapist
popgun	plaything
chevy	annoy
cabinetmaking	carpentry
transact	interact
hypnotise	sedate
azalea	rhododendron
shareholder	investor
fabian	socialist
central	workplace
groundhog	marmot
princess	aristocrat
copepod	crustacean
softy	weakling
trf	hormone
wisteria	vine
phenergan	antihistamine
subluxation	luxation
orthodontia	dentistry
freedman	freeman
camaraderie	sociability
crassness	insensitivity
landman	inhabitant
specifier	intellectual
yokel	rustic
lender	investor
grandfather	grandparent
dts	psychosis
barrelhouse	barroom
necklace	jewelry
erythropoietin	glycoprotein
invertebrate	animal
sika	deer
outcast	unfortunate
ringway	highway
gastronome	sensualist
ciliate	protozoan
dimmer	rheostat
arroyo	gully
salp	tunicate
adrenaline	vasoconstrictor
castillian	spaniard
skydiver	parachutist
capybara	rodent
corvette	warship
carthusian	monk
espadrille	sandal
embezzler	deceiver
peptidase	enzyme
blaster	workman
highflyer	achiever
plastid	granule
iga	immunoglobulin
nightshirt	nightwear
orthodontics	dentistry
debater	disputant
underskirt	undergarment
egalitarianism	doctrine
impersonator	deceiver
arsenical	pesticide
hemiplegia	paralysis
deceiver	wrongdoer
preteen	juvenile
decagon	polygon
fertiliser	chemical
lydian	anatolian
caliph	muslim
mormonism	protestantism
zoophilia	paraphilia
trafficker	merchant
arborvitae	conifer
aunty	kinswoman
dervish	fakir
progesterone	progestin
cypriot	european
calif	muslim
amitriptyline	tricyclic
inerrancy	infallibility
skinflint	hoarder
sinhala	sanskrit
hydrology	geophysics
intersex	bisexual
taxpayer	payer
housemaid	domestic
mefloquine	antimalarial
mongol	oriental
irani	asian
genomics	genetics
borrelia	spirochete
plasterboard	wallboard
ethane	hydrocarbon
fishpond	pond
scanty	underpants
maldivian	asian
burdock	subshrub
hausen	sturgeon
cigarillo	cigar
roquefort	bleu
pachyderm	placental
instinct	aptitude
glasswork	tableware
zori	sandal
adh	vasoconstrictor
overemphasize	overstate
nitroglycerin	vasodilator
certiorari	writ
gentamicin	antibiotic
coltan	mineral
goidelic	celtic
molybdenite	mineral
auberge	hotel
inventiveness	creativity
carthaginian	african
roughneck	attacker
plebeian	commoner
pulpwood	softwood
olivine	mineral
periodontist	dentist
boozer	drunkard
laureate	honoree
shunter	locomotive
neonatology	pediatrics
lauder	communicator
greenskeeper	custodian
bluffer	deceiver
hillbilly	rustic
dinnerware	tableware
flatus	reflex
adsorbent	sorbent
hatemonger	detractor
shylock	lender
methadone	narcotic
khufu	pharaoh
promisee	communicator
makeshift	expedient
physiotherapist	therapist
packaged	encase
pegleg	prosthesis
terrarium	vivarium
idiot	simpleton
meth	amphetamine
neurophysiology	neuroscience
canyon	ravine
crossbill	finch
entombment	funeral
gardenia	shrub
banality	truism
augmentin	penicillin
turfan	tocharian
modernist	artist
plover	shorebird
promethazine	antiemetic
fishwife	trader
strep	eubacteria
finesse	tact
thermocouple	thermometer
urdu	sanskrit
bot	larva
bungler	incompetent
unawareness	unconsciousness
supercharger	compressor
dermatitis	eczema
ptolemy	dynasty
fedayeen	paramilitary
coliseum	stadium
kike	jew
plosive	obstruent
corticosterone	glucocorticoid
cager	athlete
trimaran	sailboat
triazolam	benzodiazepine
tole	metalware
senator	legislator
weatherman	meteorologist
glucoside	glycoside
muntjac	deer
roamer	traveler
carjack	commandeer
necktie	neckwear
reassertion	avowal
fridge	refrigerator
masseur	massager
docker	laborer
scot	european
breadbox	container
transcriptase	polymerase
baronet	aristocrat
biopiracy	larceny
physiotherapy	therapy
allgood	goosefoot
gypsum	mineral
jonah	unfortunate
hexagon	polygon
bumbler	incompetent
griot	narrator
portico	porch
cromlech	megalith
habsburg	dynasty
bookcase	furniture
sedition	misdemeanor
ophthalmia	conjunctivitis
khoikhoi	khoisan
crag	cliff
epinephrine	catecholamine
functionality	practicality
steenbok	antelope
cnidarian	invertebrate
vibrancy	timbre
ugandan	african
adrenaline	hormone
junto	clique
whatnot	curio
gigolo	libertine
ssri	antidepressant
expat	absentee
ragnarok	myth
epinephrine	neurotransmitter
homophobe	bigot
nightdress	nightwear
okapi	giraffe
longshoreman	laborer
lymphocyte	leukocyte
garbageman	hauler
reductase	enzyme
bellbird	cotinga
bikini	swimsuit
minocycline	tetracycline
undesirability	bad
tunisian	african
trinitarianism	protestantism
weedkiller	chemical
croatian	slav
gatecrasher	intruder
cruiserweight	prizefighter
displeasure	dissatisfaction
tandoor	oven
entrepreneur	businessperson
zantac	antacid
propriety	demeanor
gran	grandparent
responder	communicator
larvicide	chemical
estriol	estrogen
pontifical	vestment
pollen	spore
egyptology	archeology
corundum	mineral
obnoxiousness	offensiveness
lamasery	monastery
peon	laborer
marum	germander
ghanian	african
healer	expert
blockhead	stupid
heptagon	polygon
railroader	employee
glucagon	hormone
barman	employee
geographer	expert
derringer	pistol
marginalise	interact
clumber	spaniel
jadeite	mineral
aftertaste	afterimage
ponytail	hairdo
morphia	analgesic
desuetude	inaction
tantalite	mineral
bloodstone	chalcedony
neocolonialism	colonialism
gaoler	lawman
bougainvillea	vine
pentothal	barbiturate
lowlander	scot
pleaser	entertainer
sweatshop	factory
ventriloquist	performer
faqir	muslim
andorran	european
bowtie	necktie
opium	narcotic
purebred	animal
tagamet	antacid
tetrapod	vertebrate
streptococci	eubacteria
brontosaurus	sauropod
tritium	hydrogen
infallibility	dependability
sniper	marksman
cholla	cactus
equivocate	misinform
tress	hairdo
weathercock	weathervane
wiz	expert
kudzu	vine
actinomyces	eubacteria
apatite	mineral
panicle	raceme
cenobite	religious
hyperplasia	dysplasia
phosphatase	enzyme
unilateralism	doctrine
doxycycline	antibiotic
signaler	communicator
magdalen	sinner
commercialism	transaction
oxymoron	trope
monday	weekday
nasality	timbre
rapier	sword
oryx	antelope
hanover	dynasty
lamisil	antifungal
simile	trope
expropriation	confiscation
iraqi	asian
bacterium	microorganism
sandstorm	windstorm
trilateral	polygon
mullah	muslim
cyberwar	terrorism
radiotherapy	therapy
paleopathology	archeology
gat	pistol
epidemic	outbreak
grevillea	shrub
rifampin	antibacterial
paperboy	deliveryman
maharani	princess
lysozyme	enzyme
selfishness	stinginess
squib	firework
homozygote	zygote
vegan	vegetarian
stayer	animal
primidone	anticonvulsant
underclothes	undergarment
warden	lawman
steelworks	factory
footballer	athlete
chitin	polysaccharide
irreligion	impiety
lapwing	plover
spironolactone	antihypertensive
demonstrative	pronoun
logger	laborer
cephalosporin	antibiotic
basidiomycete	fungus
seminoma	carcinoma
acth	hormone
neurontin	anticonvulsant
egomaniac	egotist
neurotransmitter	neurochemical
seigneur	overlord
antiquary	expert
colonist	migrant
beefsteak	steak
european	inhabitant
claptrap	grandiosity
apocalypse	calamity
banksia	shrub
hireling	employee
receptiveness	willingness
sleight	adeptness
mifepristone	abortifacient
reformist	disputant
cornelian	chalcedony
kob	waterbuck
spirometry	measurement
emitter	electrode
concubinage	cohabitation
plagiarist	thief
quinacrine	antimalarial
kunzite	spodumene
reefer	cigarette
embalmer	mortician
cardinalate	clergy
strider	pedestrian
apomorphine	morphine
pleader	lawyer
pseudoephedrine	alkaloid
absolutist	disciple
livestock	placental
aardwolf	hyena
grifter	deceiver
videocassette	cassette
moniker	appellation
pessimist	skeptic
candelabrum	candlestick
hytrin	antihypertensive
narcosis	unconsciousness
lignin	polymer
bobcat	lynx
ethyl	alkyl
industrialist	businessman
bribery	felony
kidnapper	criminal
jaggery	carbohydrate
millrace	conduit
willpower	resoluteness
arbitrariness	irresponsibility
vasopressin	vasoconstrictor
gorgonzola	bleu
botanist	biologist
eosinophil	leukocyte
gnu	antelope
methyltestosterone	androgen
poinsettia	spurge
inulin	polysaccharide
elegy	poem
quagga	equine
cred	credibility
codefendant	defendant
postgraduate	collegian
melancholic	depressive
strumpet	adulterer
cryolite	mineral
companionship	friendship
scopolamine	alkaloid
portable	typewriter
tachograph	tachometer
hubris	arrogance
garibaldi	blouse
maleate	antidepressant
rna	polymer
shouter	communicator
demographic	statistic
demeanor	trait
botulinum	eubacteria
fentanyl	analgesic
daycare	childcare
missus	wife
broadsword	sword
valour	courage
disease	illness
pontiff	catholic
maestro	artist
collude	interact
quadruped	tetrapod
grazier	rancher
didanosine	antiviral
oenophile	appreciator
moroccan	african
fenland	wetland
extroversion	sociability
epiphyllum	cactus
phalarope	shorebird
depositor	investor
atropine	alkaloid
byzantine	asian
battleship	warship
docudrama	movie
grandson	grandchild
faithlessness	infidelity
tannoy	loudspeaker
workingman	employee
sunbather	idler
criminalise	forbid
bluenose	canadian
fogey	oldster
neomycin	antibiotic
paca	rodent
cordierite	mineral
apar	armadillo
opsin	protein
requester	applicant
sinner	wrongdoer
ferritin	protein
photocell	transducer
sputum	mucus
bihari	sanskrit
tallis	shawl
voyeurism	paraphilia
hrt	therapy
continent	landmass
pentoxide	oxide
copywriter	employee
ephedra	shrub
souvlaki	kabob
caribou	deer
chloramphenicol	antibiotic
impresario	booker
ecoterrorism	terrorism
perigee	periapsis
bhutani	asian
bombast	grandiosity
mynah	starling
greaser	mexican
handbasket	container
obduracy	resoluteness
slyness	shrewdness
reconciler	mediator
jasmine	shrub
scottie	terrier
silicosis	pneumoconiosis
hesitance	diffidence
quesadilla	burrito
communicant	christian
opportunism	selfishness
sentinel	watchman
polychaete	annelid
cannister	container
disparity	inequality
tremolite	asbestos
disarmament	demobilization
masseuse	massager
disenchanted	disappoint
prolactin	gonadotropin
deuterium	isotope
caragana	shrub
busybody	meddler
zhou	dynasty
urease	enzyme
prognostic	augury
wimple	headdress
rozelle	hibiscus
lockbox	strongbox
purveyor	supplier
jacobean	englishman
ennui	dissatisfaction
deoxyribose	carbohydrate
hexose	monosaccharide
laborer	workman
handbag	container
aggrandize	overstate
fitment	furniture
maleate	ester
quadriplegia	paralysis
brasserie	restaurant
salvinorin	hallucinogen
spodumene	mineral
hagiography	biography
nucleon	baryon
cassie	acacia
cheatgrass	brome
paperboard	cardboard
minnow	cyprinid
oca	oxalis
relaxin	hormone
majolica	earthenware
dioxide	oxide
contras	nicaraguan
hydralazine	vasodilator
morphine	analgesic
slovenian	european
monocot	angiosperm
tailplane	airfoil
mirasol	sunflower
commonplace	truism
decarboxylase	enzyme
lawbreaker	criminal
lolita	lass
disinformation	misinformation
quin	sibling
geostrategy	geopolitics
vaccine	immunogen
pissed	excrete
contextualism	doctrine
portent	augury
bryony	vine
pugilist	combatant
dubbin	tallow
celt	european
arbitrator	evaluator
harvestman	arachnid
dissatisfaction	discontentment
endotoxin	toxin
tocopherol	antioxidant
guyot	seamount
spinel	mineral
untrustworthiness	trait
bandit	thief
pharmacologist	pharmacist
arcus	cornea
halcion	benzodiazepine
bistro	restaurant
tux	formalwear
hostelry	hotel
congresswoman	legislator
pallbearer	mourner
naziism	fascism
larceny	felony
deportment	trait
adenosine	nucleoside
cooly	asian
blockhouse	stronghold
sphagnum	moss
gastroscopy	endoscopy
bicentenary	anniversary
dotterel	plover
antinomian	disciple
franklin	landowner
metonymy	trope
seb	bioweapon
trembler	coward
signalman	trainman
copolymer	polymer
hurler	ballplayer
licensee	retailer
willies	edginess
dismemberment	mutilation
zamia	cycad
kitchenette	kitchen
maalox	antacid
americana	artifact
paparazzo	photographer
sansevieria	agave
fet	transistor
galliano	liqueur
acidophilus	lactobacillus
pylorus	orifice
headscarf	kerchief
wallaby	kangaroo
frequenter	customer
emigre	migrant
conquistador	explorer
tce	ethylene
musette	bagpipe
couture	dressmaking
thetis	nereid
pheochromocytoma	tumor
euglena	protozoan
cider	beverage
ascidian	tunicate
pakistani	asian
transgene	gene
undies	lingerie
greasewood	shrub
raper	attacker
moonshiner	criminal
cytoplasm	protoplasm
vervet	guenon
phalangist	fascist
guinean	african
bumpkin	rustic
schlepper	simpleton
fuchsia	shrub
molasses	syrup
rima	orifice
psychologist	scientist
thespian	performer
interstate	highway
gunslinger	murderer
iud	contraceptive
cranesbill	geranium
performer	entertainer
comic	performer
essene	jew
laparoscopy	laparotomy
chewer	consumer
aerolite	meteorite
beryl	mineral
godmother	godparent
centurion	warrior
ddc	antiviral
proprietor	businessman
polymerase	enzyme
encephalartos	cycad
tannery	workplace
bromine	halogen
velodrome	racetrack
stepmother	stepparent
fibroid	fibroma
osteopath	therapist
nicotine	vasoconstrictor
hostage	prisoner
stepfather	stepparent
affirmative	avowal
satanist	disciple
laotian	asian
carapace	scute
revers	lapel
gully	valley
mineralocorticoid	corticosteroid
psychopath	neurotic
friary	monastery
pollute	dirty
chrysalis	pupa
subroutine	software
goldenrod	wildflower
gamekeeper	custodian
mylanta	antacid
beekeeper	farmer
absentee	traveler
emptor	customer
sadomasochism	sadism
niece	kinswoman
icosahedron	polyhedron
rosacea	acne
collectable	curio
mailman	deliveryman
bindweed	vine
quebecois	canadian
behaviorist	psychologist
lowbrow	plebeian
tsunami	calamity
schoolmistress	schoolteacher
musical	movie
trinitarian	disciple
ecotourism	tourism
emesis	reflex
bph	hyperplasia
cistercian	monk
astrology	pseudoscience
hyperboloid	quadric
underpants	undergarment
hewer	laborer
teratoma	tumor
staph	coccus
demonisation	disapprobation
messiah	savior
stinginess	trait
contrabassoon	bassoon
polyandry	polygamy
precision	exactness
dysphoria	discontentment
cassowary	ratite
anxiolytic	tranquilizer
biplane	airplane
hymnal	songbook
hallway	corridor
sheetrock	plasterboard
paddler	boatman
microbrewery	brewery
millpond	pond
wonderment	astonishment
pyrite	mineral
cafe	restaurant
hussy	adulterer
trivialise	understate
protease	enzyme
saleslady	salesperson
haircut	hairdo
patrolman	lawman
microtubule	tubule
lumbago	backache
purposefulness	meaningfulness
isoniazid	antibacterial
demiurge	deity
seafront	waterfront
hyrax	placental
mick	irishman
photocopier	duplicator
tues	weekday
fuller	workman
kurdistan	rug
marginalize	interact
ciprofloxacin	antibiotic
freeloader	borrower
moonstone	feldspar
polyurethane	polymer
ayah	domestic
recalcitrance	intractability
bijou	jewelry
tetrodotoxin	neurotoxin
briber	criminal
dormouse	rodent
aku	kwa
clothier	merchant
monetarist	economist
complainant	litigant
millenarian	optimist
smuggler	criminal
gaillardia	wildflower
monazite	mineral
fickleness	infidelity
yucca	shrub
freeholder	landowner
spironolactone	corticosteroid
octane	hydrocarbon
neutron	nucleon
apatosaurus	sauropod
acrylamide	amide
dexedrine	amphetamine
pantyhose	tights
signalman	signaler
cattleya	orchid
daydreamer	idler
polyamide	polymer
jewess	jew
kampuchean	asian
pseudoscience	fallacy
advertorial	ad
zirconia	oxide
highroad	highway
cebuano	philippine
stakeout	surveillance
phlogopite	mica
geodesy	geophysics
thruway	highway
sellers	merchant
looter	thief
spurge	shrub
pantry	storeroom
trivialize	understate
phototherapy	radiotherapy
appeaser	conciliator
grandpa	grandparent
eland	antelope
baptism	sacrament
cosmonaut	traveler
teen	juvenile
paranoia	psychosis
ancestress	ancestor
zabaglione	dessert
lipase	enzyme
geneticist	biologist
prebend	stipend
sentry	watchman
airedale	terrier
minah	starling
camelia	shrub
macoun	mcintosh
junkers	prussian
warner	communicator
precipice	cliff
pollster	inquirer
grantor	granter
monoclonal	antibody
granddaddy	grandparent
scrooge	hoarder
homesickness	nostalgia
scholia	marginalia
shawm	oboe
outlander	traveler
mydriasis	reflex
acetylation	acylation
agitator	troublemaker
aquarium	vivarium
maneuverability	mobility
pomeranian	spitz
lectin	glycoprotein
acetylcholine	neurotransmitter
hibiscus	mallow
lancaster	dynasty
escapist	daydreamer
mod	adolescent
nilgai	antelope
effendi	turk
moxie	fortitude
lymphedema	edema
gunnery	weaponry
hornblende	amphibole
endodontics	dentistry
morphia	opiate
arbitrageur	businessman
obscurantist	deceiver
adrenaline	neurotransmitter
adiposity	fatness
molester	wrongdoer
sportswoman	athlete
marathi	sanskrit
matchmaker	mediator
kimberlite	peridotite
recessive	allele
chorister	singer
cymry	european
theorist	intellectual
haptoglobin	protein
wormwood	subshrub
toxicology	pharmacology
sigmoidoscopy	endoscopy
streptokinase	enzyme
cytidine	nucleoside
modeler	creator
lexis	cognition
adman	publicist
lysol	cresol
youngster	juvenile
disciplinarian	authoritarian
civilian	citizen
thalidomide	teratogen
serb	slav
spode	porcelain
wadi	gully
ect	electrotherapy
bitumen	hydrocarbon
umayyad	dynasty
hn	explosive
prankster	troublemaker
permeability	porosity
slingshot	plaything
trypsin	enzyme
kenyan	african
cosmologist	astronomer
orbiter	equipment
pastis	liqueur
herbicide	chemical
paraprofessional	assistant
milkwort	subshrub
protein	macromolecule
tnf	cytokine
psilocin	hallucinogen
aileron	airfoil
unitarianism	protestantism
catclaw	shrub
burundian	african
parathion	insecticide
neutropenia	leukopenia
aldose	monosaccharide
bouffant	hairdo
phospholipid	lipid
spectrometer	spectroscope
cer	emotion
precognition	clairvoyance
pinhead	simpleton
jnr	son
zoologist	biologist
deliveryman	employee
silversword	shrub
wombat	marsupial
parader	pedestrian
aragonite	mineral
nigerian	african
granulocyte	leukocyte
hussite	disciple
anthropometry	measurement
monacan	european
igloo	hovel
anthurium	houseplant
verandah	porch
plaything	artifact
busker	entertainer
strad	violin
stonecrop	sedum
instructor	educator
mallow	shrub
cavy	rodent
atrazine	herbicide
cowrie	gastropod
cachexia	infirmity
theft	felony
aramean	semite
gullibility	naivete
choreographer	creator
colonoscopy	endoscopy
gritstone	sandstone
granddad	grandparent
scrumpy	cider
thriftiness	frugality
adsorption	sorption
marabout	stork
pyracantha	shrub
cataloguer	librarian
adulation	flattery
sambar	deer
anabaptism	protestantism
pangolin	placental
silica	oxide
suggestibility	susceptibility
dramamine	antiemetic
forebear	ancestor
babushka	headscarf
anus	orifice
beduin	nomad
citadel	stronghold
starship	spacecraft
tabbouleh	salad
centriole	organelle
goitre	disease
senegalese	african
dhal	shrub
vagrancy	homelessness
cretan	european
uke	guitar
dp	refugee
scattergood	prodigal
bannock	flatbread
wetback	mexican
overstated	misinform
monocyte	leukocyte
anatomist	expert
zambian	african
hydralazine	antihypertensive
hydrangea	shrub
facilitator	assistant
sculler	oarsman
newsreader	newscaster
totara	conifer
presbyterianism	protestantism
indiscipline	trait
lactobacillus	eubacteria
interrogator	inquirer
aminotransferase	transferase
lyrebird	passerine
stepson	stepchild
toyon	shrub
meningoencephalitis	meningitis
swineherd	herder
officiant	clergyman
asbestosis	pneumoconiosis
landscaper	architect
hoaxer	troublemaker
secularism	doctrine
emotionalism	trait
guestroom	bedroom
boredom	dissatisfaction
literati	intelligentsia
nazism	fascism
pub	tavern
wellness	wellbeing
hydrochlorothiazide	thiazide
russet	homespun
corynebacterium	eubacteria
assailant	wrongdoer
charterhouse	monastery
shareware	software
footman	manservant
blastocyst	blastula
ergotamine	alkaloid
sampan	skiff
sabra	israeli
ninny	simpleton
sensitive	psychic
guerilla	warrior
quirkiness	unfamiliarity
jihadist	muslim
tatou	armadillo
persuader	communicator
preemie	neonate
stopgap	expedient
falange	nazism
entailment	inference
nudibranch	gastropod
fluoride	halide
oligosaccharide	carbohydrate
strongroom	storeroom
cotoneaster	shrub
microelectronics	electronics
spathe	bract
quietist	mystic
philadelphus	shrub
ribosome	organelle
dissatisfied	displease
mauritanian	african
nostril	naris
gourmet	sensualist
landfill	lowland
calvados	brandy
documentary	movie
methyl	alkyl
trainman	employee
craven	coward
fibrin	protein
gonadotropin	hormone
igm	immunoglobulin
akan	kwa
activase	thrombolytic
hydromorphone	analgesic
pythium	fungus
accuser	disputant
audiocassette	cassette
australopithecine	hominid
laxative	purgative
granuloma	tumor
coxswain	helmsman
oxidase	enzyme
demeanour	trait
fusil	musket
critter	animal
expansionism	doctrine
sucrose	disaccharide
rioter	troublemaker
animist	disciple
carrel	alcove
encrypt	encode
unknowing	ignorance
sacredness	holiness
sulfonylurea	antidiabetic
balladeer	singer
rutile	mineral
executrix	executor
litoral	seashore
diazonium	cation
herbalist	therapist
plantsman	expert
xanax	benzodiazepine
salal	shrub
coumadin	anticoagulant
platypus	monotreme
tableland	highland
neuroethics	bioethics
hudood	shariah
glassware	tableware
br	halogen
husbandman	creator
ultima	syllable
importer	businessperson
diplodocus	dinosaur
fundamentalism	protestantism
microflora	microorganism
pharmacokinetics	pharmacology
doberman	pinscher
wife	spouse
bullfinch	finch
osteomyelitis	osteitis
pyroxene	mineral
succinctness	terseness
sensationalist	publicist
pariah	unfortunate
peeved	annoy
logrono	spain
freeman	citizen
nitroglycerine	vasodilator
saltbush	shrub
molter	animal
mediator	negotiator
algerian	african
commie	socialist
caff	cafe
subprogram	software
yobo	attacker
fetus	vertebrate
epigenesis	metamorphism
scepticism	unbelief
woodland	biome
diatom	alga
aviatrix	aviator
lensman	artist
sheepherder	herder
cosmogony	astrophysics
nigerien	african
tideland	seashore
heathland	barren
lander	spacecraft
eucharist	sacrament
demonization	disapprobation
cassette	container
testosterone	androgen
cutthroat	murderer
chromite	mineral
seaside	seashore
ranee	aristocrat
dutchman	european
impostor	deceiver
catholic	christian
bandicoot	marsupial
gasman	employee
homeopath	practitioner
immunotherapy	therapy
ldl	lipoprotein
atropine	antidote
arachnid	arthropod
sectarian	bigot
chaffinch	finch
diatom	phytoplankton
fallacy	misconception
paintbrush	applicator
alarmist	communicator
neckerchief	kerchief
cortisone	corticosteroid
bohemia	clique
caffeine	alkaloid
carotenoid	phytochemical
adrenalin	catecholamine
saviour	benefactor
reformism	doctrine
namibian	african
stupid	simpleton
misogynist	misanthrope
thrombophlebitis	phlebitis
woodcutter	laborer
invader	intruder
intrepidity	courage
arethusa	orchid
centrex	central
killdeer	plover
tearaway	daredevil
prevue	ad
kalmia	shrub
malvasia	vinifera
kwashiorkor	malnutrition
outlawed	forbid
parallelogram	quadrilateral
petrol	hydrocarbon
tailcoat	formalwear
toupee	hairpiece
ballplayer	athlete
stacker	laborer
meningoencephalitis	encephalitis
contortionist	acrobat
tine	prong
inh	antibacterial
zithromax	antibacterial
staffer	employee
meson	hadron
handedness	asymmetry
barytes	mineral
trilobite	arthropod
archduke	prince
spyware	software
spastic	paralytic
maoi	antidepressant
shyster	wrongdoer
safecracker	thief
teahouse	restaurant
sabayon	dessert
maven	expert
cricketer	athlete
deckhand	mariner
streptomycin	antibiotic
cambrian	european
leaver	migrant
naturist	individualist
antiperspirant	toiletry
butler	manservant
scarecrow	effigy
galago	lemur
chickadee	titmouse
pocked	deface
arraign	accuse
gunflint	flint
glaswegian	scot
serape	shawl
polytheism	theism
lego	plaything
loner	individualist
cutler	trader
nonproliferation	prevention
backpacker	hiker
gael	celt
spliff	cigarette
ethene	alkene
mediatrix	mediator
parisian	frenchman
symbology	ology
brassiere	undergarment
perpetrator	wrongdoer
endothelium	epithelium
foreleg	forelimb
tornillo	mesquite
gramicidin	antibiotic
ddt	pollutant
shlock	merchandise
molehill	knoll
sower	farmer
estimator	expert
warrener	gamekeeper
scrofula	tuberculosis
chemotherapy	therapy
angioedema	edema
maiolica	earthenware
indigence	poverty
bluejacket	serviceman
bacteriologist	biologist
progenitor	ancestor
paraplegia	paralysis
crustacean	arthropod
crockery	tableware
desperate	unfortunate
gofer	employee
sciatica	neuralgia
switcher	oppressor
transcend	excel
foetus	vertebrate
artemisia	shrub
egghead	intellectual
mickey	irishman
egret	heron
sperm	gamete
dosimetry	measurement
lipoma	tumor
materiel	equipment
absorbency	permeability
conspirator	criminal
bra	undergarment
morphine	opiate
coccus	eubacteria
reindeer	deer
inefficacy	ineffectiveness
unkindness	insensitivity
anglicanism	protestantism
applejack	brandy
landlady	landlord
giraffe	ruminant
atheist	disbeliever
fascist	rightist
woodcarver	woodworker
everyman	commoner
christ	savior
hudud	shariah
gasworks	workplace
adulterer	libertine
orthodontist	dentist
rheostat	resistor
murre	guillemot
lutheranism	protestantism
gastropod	mollusk
miner	laborer
terpene	hydrocarbon
claro	cigar
avocation	pastime
winterberry	holly
bakeshop	workplace
osteosarcoma	sarcoma
ativan	benzodiazepine
asian	inhabitant
episteme	cognition
aesthete	connoisseur
assessor	bureaucrat
aldosterone	mineralocorticoid
parapsychologist	psychologist
geomorphology	geophysics
discotheque	ballroom
prematurity	immaturity
mayflower	shrub
acetone	ketone
privet	shrub
clostridia	eubacteria
phony	deceiver
prisoner	unfortunate
colonic	enema
boatswain	mariner
sender	communicator
thatcher	roofer
absorbent	sorbent
thief	criminal
orangery	greenhouse
roue	libertine
croissant	bun
rundown	summary
candelabra	candlestick
holidaymaker	traveler
demography	sociology
affricate	obstruent
jammies	nightwear
storekeeper	merchant
frogman	explorer
cadet	trainee
bizarreness	unfamiliarity
supergrass	informer
cosmetologist	expert
bakery	workplace
jailbird	criminal
palliate	apologize
rasta	disciple
sudafed	vasoconstrictor
pityriasis	dermatosis
crooner	singer
somatotropin	hormone
backstairs	stairway
dace	cyprinid
seagrass	seaweed
undergraduate	collegian
devon	cattle
hobo	vagrant
signaller	communicator
gluten	protein
tearjerker	narrative
cremains	cadaver
woofer	loudspeaker
ecclesiastic	clergyman
technophile	fancier
jerboa	rodent
budgerigar	parakeet
obsequiousness	submissiveness
trimer	polymer
latte	espresso
fibrocartilage	cartilage
arsenopyrite	mineral
franciscan	friar
kaon	meson
underboss	assistant
paedophilia	paraphilia
nobelist	laureate
abalone	gastropod
lagan	wreckage
stabber	attacker
penknife	pocketknife
bacteria	microorganism
flammability	combustibility
lipid	macromolecule
faker	deceiver
policewoman	policeman
foreknowledge	clairvoyance
egyptologist	archeologist
ricin	toxin
islander	inhabitant
littoral	seashore
rapist	attacker
lunacy	insanity
exocrine	gland
dunkard	baptist
scag	heroin
mettle	courage
unruliness	intractability
astrophysicist	astronomer
nucleoside	glycoside
lorikeet	lory
redshank	sandpiper
bedroll	bedclothes
parson	clergyman
microbe	microorganism
monophysite	disciple
creditworthiness	trustworthiness
purist	pedant
springiness	elasticity
polysaccharide	carbohydrate
freon	chlorofluorocarbon
lingerie	underwear
glen	valley
overstate	misinform
gaelic	celtic
textile	artifact
motorcyclist	traveler
antiserum	serum
ebitda	income
logician	expert
guidebook	handbook
chlordiazepoxide	benzodiazepine
grisaille	chiaroscuro
romanism	catholicism
probiotic	bacteria
jinks	merrymaking
treater	communicator
stagehand	employee
waterbuck	antelope
polystyrene	styrene
batsman	ballplayer
manichean	disciple
pterodactyl	pterosaur
bvd	underwear
demean	humiliate
gesso	gypsum
candida	fungus
staphylococcus	coccus
dominie	clergyman
limekiln	kiln
disgruntlement	discontentment
trh	hormone
fertilizer	chemical
norepinephrine	catecholamine
stratigraphy	geology
costumer	couturier
angioma	tumor
phoney	deceiver
adrenaline	catecholamine
crafter	creator
zealander	dane
clambake	cookout
gasoline	hydrocarbon
ed	dysfunction
epinephrine	hormone
dockworker	laborer
balkans	european
mortgagee	creditor
manoeuvrability	mobility
alkalinity	ph
mendacity	untruthfulness
cardura	antihypertensive
allophone	phoneme
milquetoast	coward
matchlock	musket
counterpane	bedclothes
flotsam	wreckage
definiteness	predictability
preterist	theologian
breeder	stockman
friday	weekday
neurobiologist	biologist
ironclad	warship
peptide	amide
obsessive	neurotic
seller	merchant
acetyl	acyl
minion	dependant
allamanda	vine
kuwaiti	asian
spiv	idler
paleontologist	scientist
workbench	worktable
flavonoid	phytochemical
creamery	workplace
fsh	gonadotropin
overview	summary
betaine	alkaloid
biltong	jerky
warthog	swine
zoroastrian	disciple
grower	farmer
moss	bryophyte
seaboard	seashore
dendrobium	orchid
heroin	opiate
softener	chemical
jacobin	terrorist
milker	cattle
antitoxin	antibody
biped	animal
percolator	coffeepot
trioxide	oxide
stipendiary	magistrate
gradual	antiphon
cucurbit	cucurbitaceae
brawler	combatant
centipede	arthropod
ichneumon	mongoose
cholinesterase	enzyme
bonemeal	organic
frottage	masturbation
gout	arthritis
illiterate	ignoramus
lanai	veranda
evangelicalism	protestantism
israeli	asian
intractability	trait
mudder	racehorse
goiter	disease
mammillaria	cactus
angiotensin	vasoconstrictor
handyman	repairman
authoritarian	oppressor
heliotrope	chalcedony
akkadian	semitic
uncleanliness	trait
executor	fiduciary
naif	innocent
petticoat	undergarment
dichroism	pleochroism
trypsinogen	trypsin
tapeworm	flatworm
invitee	visitor
accomplice	assistant
pyrrhotite	mineral
castrato	singer
caduceus	insignia
hyoscyamine	alkaloid
adh	hormone
occupant	inhabitant
meany	oppressor
letterhead	stationery
lusatian	slavic
zeugma	trope
hubby	spouse
tradesman	merchant
tularemia	zoonosis
penultimate	syllable
protist	microorganism
crasher	intruder
retailer	merchant
roselle	hibiscus
labourer	workman
extenuating	apologize
burgomaster	mayor
nagi	conifer
caterer	supplier
disproportion	disparity
brythonic	celtic
dunnock	accentor
psychometrics	psychology
blain	sore
pederasty	homosexuality
homemaker	wife
infotainment	movie
avens	subshrub
malawian	african
organophosphate	insecticide
raper	criminal
prodigal	consumer
bullring	stadium
monk	religious
prince	aristocrat
milkmaid	farmhand
puffin	seabird
destitution	poverty
endorphin	neurochemical
berk	stupid
ukulele	guitar
hoya	vine
microeconomics	economics
serjeant	barrister
magnetics	geophysics
myna	starling
moistness	wetness
cossack	slav
onomastics	lexicology
messenger	traveler
ketchup	condiment
shiite	muslim
postman	deliveryman
bittern	heron
eeriness	unfamiliarity
irelander	european
burglary	felony
millerite	mineral
chopstick	tableware
camarilla	clique
pterygium	conjunctiva
acrobat	athlete
hexahedron	polyhedron
sardonyx	onyx
edo	nigerian
mycobacterium	eubacteria
victimisation	mistreatment
nibbler	biter
dinka	nilotic
virginal	harpsichord
rubella	measles
epic	poem
femininity	trait
finn	european
shipyard	workplace
nephron	tubule
cannery	factory
lecithin	phospholipid
claimant	applicant
admissibility	acceptability
econometrics	economics
grubby	sculpin
insincerity	untruthfulness
synthesist	intellectual
counterfeiter	deceiver
arioso	recitative
septicemia	sepsis
sorcerer	occultist
chalcocite	mineral
singaporean	asian
psychophysiology	psychology
headliner	performer
intercessor	negotiator
worse	bad
brewpub	restaurant
beachcomber	vagrant
noma	ulcer
cephalopod	mollusk
salver	tray
bronc	mustang
macroeconomics	economics
phenylephrine	adrenergic
disinterestedness	impartiality
iroquoian	amerind
loir	dormouse
guerrilla	warrior
cipro	antibiotic
lyssa	zoonosis
winger	athlete
sharper	swindler
passerby	pedestrian
obstructionist	disputant
gabapentin	anticonvulsant
camellia	shrub
congolese	african
redeployment	deployment
pentaerythritol	vasodilator
whippet	greyhound
grandad	grandparent
alcoholic	drunkard
conceptus	animal
guanaco	llama
spelunker	explorer
groupware	software
inculcation	indoctrination
cockiness	assertiveness
ostracod	crustacean
tetrafluoroethylene	fluorocarbon
bartender	employee
actinomycete	eubacteria
proletarian	commoner
megalomaniac	egotist
pepsin	enzyme
chloroquine	antimalarial
subwoofer	loudspeaker
taxonomist	biologist
dle	lupus
grosbeak	finch
isomerase	enzyme
manichaean	disciple
peacenik	pacifist
onyx	chalcedony
silicone	polymer
greenshank	sandpiper
kelt	european
paleobiology	paleontology
motile	perceiver
macrobiotics	dietetics
cinematographer	photographer
mesquite	shrub
midsummer	solstice
exporter	businessperson
fri	weekday
manger	container
fortitude	courage
decorum	propriety
oarsman	boatman
valedictory	oratory
pogrom	persecution
auntie	kinswoman
demagogy	entreaty
narc	lawman
penology	criminology
treponema	spirochete
kutch	tannin
ribonuclease	transferase
tiramisu	dessert
thistledown	pappus
wheelwright	wright
adolescent	juvenile
intuit	grok
wastrel	prodigal
thug	criminal
mennonite	anabaptist
glucocorticoid	hormone
disillusioning	disappoint
amontillado	sherry
hosier	shopkeeper
wastebasket	container
parisienne	parisian
defendant	litigant
thymosin	hormone
hippodrome	stadium
cyclooxygenase	enzyme
maharajah	prince
nihil	nothing
inosine	nucleoside
grecian	european
circular	ad
ddi	antiviral
preacher	clergyman
epicene	bisexual
spermicide	contraceptive
breathlessness	dyspnea
womanizer	libertine
dustman	hauler
pion	meson
airport	airfield
gymnast	athlete
amiodarone	antiarrhythmic
breadwinner	earner
timberland	biome
embezzlement	larceny
bondholder	investor
cajun	acadian
agronomist	expert
voyager	traveler
exegete	expert
aspirin	salicylate
epicureanism	doctrine
liana	vine
ulster	greatcoat
tortilla	pancake
arthropod	invertebrate
larva	animal
rentier	investor
monoamine	amine
mucuna	shrub
zill	cymbal
gunner	serviceman
rex	sovereign
skier	athlete
shabu	amphetamine
rathskeller	tavern
kopje	knoll
cataloger	librarian
antipasto	appetizer
oncogene	gene
pilocarpine	alkaloid
cheroot	cigar
freeway	highway
trainmaster	trainman
croat	slav
fleabag	hotel
firth	estuary
ethnologist	anthropologist
spokeswoman	spokesperson
psychopharmacology	pharmacology
chinaware	crockery
cornishman	englishman
auxiliary	assistant
disturber	troublemaker
stockholder	investor
nystatin	antifungal
herpetologist	zoologist
receptivity	willingness
plateau	highland
haj	pilgrimage
zircon	mineral
nostoc	cyanobacteria
odontoglossum	orchid
coelogyne	orchid
hitman	murderer
midazolam	benzodiazepine
salesman	salesperson
elope	flee
fortuneteller	forecaster
flintstone	flint
britisher	european
reserpine	antihypertensive
sunstroke	heatstroke
childbirth	parturition
pow	prisoner
guanosine	nucleoside
vengeance	retaliation
robitussin	expectorant
noncitizen	traveler
workaholic	compulsive
subcontinent	landmass
charr	salmonid
underling	assistant
radiopharmaceutical	pharmaceutical
calcination	oxidation
colliery	workplace
alar	chemical
norvasc	vasodilator
shallon	shrub
opal	mineral
lsd	hallucinogen
defecate	excrete
ismaili	disciple
kildeer	plover
afro	hairdo
minoxidil	vasodilator
cytogenetics	cytology
mitochondrion	organelle
lechwe	waterbuck
cytosol	cytoplasm
imam	muslim
syrian	asian
presbyopia	hyperopia
enzyme	protein
nimby	dissenter
cambodian	asian
acetaldehyde	aldehyde
dromedary	camel
mycologist	botanist
grandniece	niece
tweeter	loudspeaker
scoreboard	signboard
nsu	urethritis
saxon	european
ketoacidosis	acidosis
marshland	wetland
uptick	transaction
monarchist	rightist
bursar	treasurer
catchphrase	motto
unlikelihood	improbability
secular	commoner
rogaine	vasodilator
switchblade	pocketknife
gifted	enable
cfc	fluorocarbon
parishioner	churchgoer
centerfold	foldout
credo	doctrine
navvy	laborer
aristotelian	disciple
granger	creator
lilac	shrub
bronco	mustang
cryonics	cryobiology
preclusion	prevention
climatologist	expert
bandanna	handkerchief
tourmaline	mineral
reprisal	retaliation
scion	descendant
granddaughter	grandchild
bioterrorism	terrorism
cloisonne	enamelware
numidian	inhabitant
ipecac	emetic
immigrant	migrant
swindler	deceiver
prorogation	discontinuance
bruneian	bornean
publicist	communicator
dimetapp	antihistamine
photoelectron	electron
eriogonum	subshrub
defeatist	pessimist
postmistress	postmaster
grudging	resent
shopkeeper	merchant
marrano	converso
broadsheet	ad
collier	miner
glomerulonephritis	nephritis
icelander	european
cabinetmaker	woodworker
artilleryman	serviceman
newsman	communicator
moneylender	lender
less	lupus
torturer	oppressor
quinidine	antiarrhythmic
dramamine	antihistamine
aqueduct	conduit
sahib	european
outrank	excel
sulla	subshrub
wurtzite	mineral
conch	gastropod
electrotherapy	therapy
seaweed	alga
scheelite	mineral
abelia	shrub
applicability	relevance
arabic	semitic
nightdress	lingerie
rowdy	attacker
spellbinder	orator
rnase	transferase
pandemic	epidemic
pappus	calyx
wolfsbane	aconite
dominus	clergyman
untouchable	outcast
grandnephew	nephew
tuxedo	formalwear
strychnine	alkaloid
occlusive	obstruent
porcupine	rodent
guano	organic
businesswoman	businessperson
comradeship	sociability
bayer	analgesic
usurper	wrongdoer
smugness	complacency
falchion	sword
cortisol	corticosteroid
earthwork	rampart
masai	nilotic
cimetidine	antacid
plasticine	synthetic
vldl	lipoprotein
fontanelle	orifice
plasmin	enzyme
lush	drunkard
neuroscience	neurobiology
hypnotized	sedate
hajj	pilgrimage
atp	nucleotide
bayer	salicylate
autoantibody	antibody
seconal	barbiturate
mammalian	vertebrate
humidity	wetness
spinnaker	headsail
dumpster	container
goldcrest	kinglet
mourner	unfortunate
oriental	asian
utilitarianism	doctrine
intelligibility	comprehensibility
lithops	succulent
magnetohydrodynamics	hydrodynamics
naphtha	hydrocarbon
pederasty	paraphilia
redneck	rustic
lesbianism	homosexuality
sybarite	sensualist
bushbaby	lemur
culprit	wrongdoer
roadworthiness	worthiness
embezzler	thief
swordsman	combatant
fabricator	liar
liberator	benefactor
zooplankton	animal
igg	immunoglobulin
biotite	mica
defoliated	denude
vitrine	container
chloroprene	butadiene
ovum	gamete
liberian	african
helmsman	mariner
charlotte	dessert
layman	commoner
carcinoid	tumor
phenylpropanolamine	adrenergic
mauler	combatant
benadryl	antihistamine
yardie	gangster
urinalysis	diagnosis
kindergarten	preschool
vermiculite	mineral
stonecutter	quarryman
pedlar	seller
silverback	gorilla
headsman	executioner
palaeontologist	scientist
sceptic	intellectual
bahai	disciple
annoyed	displease
grassland	biome
subnormal	simpleton
opiate	narcotic
dualist	disciple
mao	enzyme
nepheline	mineral
robber	thief
plebe	trainee
wilton	rug
defoliate	denude
condom	contraceptive
lycopene	carotenoid
pichi	shrub
chapati	flatbread
guillemot	auk
demographer	sociologist
interferon	antiviral
abscond	flee
stationer	merchant
quincentenary	anniversary
bakehouse	workplace
migrant	traveler
recusant	dissenter
bicentennial	anniversary
blackshirt	fascist
animism	doctrine
pauperism	poverty
swagman	itinerant
plasticizer	softener
pekan	marten
doorjamb	jamb
printmaker	artist
nightie	nightwear
chlorofluorocarbon	pollutant
compulsivity	trait
dane	european
rower	boatman
spokesman	spokesperson
hurdler	athlete
anoxia	hypoxia
obstinate	persevere
polypeptide	peptide
theoretician	intellectual
technophobe	naysayer
wahhabi	muslim
ukranian	european
fulbe	african
fabulist	narrator
pictorial	periodical
balkan	european
pleuropneumonia	pleurisy
bridgework	denture
prosecutor	lawyer
adulteress	adulterer
rimu	conifer
popularizer	communicator
brachiopod	invertebrate
reapportion	allocate
pentecostalism	protestantism
tautog	wrasse
maxillaria	orchid
peccadillo	misbehavior
chordate	animal
drome	airfield
patentee	inventor
softie	weakling
mesothelioma	carcinoma
convolvulus	vine
prilosec	antacid
milliner	merchant
passenger	traveler
plaintiff	litigant
bloodworm	polychaete
burster	explosive
estrone	estrogen
reacquaint	familiarize
cremation	incineration
noradrenaline	catecholamine
adsorbate	sorbate
monegasque	european
hymnbook	songbook
loveseat	sofa
welcher	swindler
pernod	liqueur
congregationalism	protestantism
juggler	performer
housewife	wife
bloodsucker	annelid
humulin	insulin
acrylonitrile	nitrile
begum	muslim
agriculturist	farmer
westerner	inhabitant
propoxyphene	analgesic
tylenol	analgesic
decolletage	neckline
jacinth	zircon
medoc	bordeaux
xylose	carbohydrate
tyrannosaur	theropod
conspectus	summary
rapist	criminal
eurasian	asian
adept	expert
psychometry	psychology
frangipani	shrub
sparer	benefactor
dauphin	prince
avionics	aeronautics
alcalde	mayor
zeolite	mineral
ammo	weaponry
domine	clergyman
nanotube	fullerene
decker	artifact
entomologist	zoologist
cassiterite	mineral
gamba	viol
geologist	scientist
sissy	coward
spermatogenesis	gametogenesis
columbite	mineral
platelet	protoplasm
comptroller	businessperson
trematode	flatworm
hollander	european
latinae	subfamily
arles	earnest
phosphor	synthetic
unabridged	dictionary
oration	oratory
candlewood	shrub
angioma	angiopathy
salsa	condiment
epinephrine	vasoconstrictor
promisor	communicator
bandeau	undergarment
raconteur	narrator
blunderbuss	musket
minoan	cretan
nadp	coenzyme
buyer	customer
towhee	finch
ruffian	attacker
airscrew	propeller
lithographer	printmaker
baryon	hadron
meperidine	narcotic
ley	grassland
ubiquinone	quinone
intelligentsia	elite
worrier	spoilsport
miro	conifer
willfulness	intractability
saponin	glucoside
mountebank	deceiver
sadomasochism	masochism
backbencher	legislator
proton	nucleon
imbecile	simpleton
passionflower	vine
cordwood	firewood
penthouse	apartment
rotenone	insecticide
plausibility	credibility
expositor	intellectual
commodity	artifact
obesity	fatness
bacitracin	antibiotic
triglyceride	lipid
exarchate	diocese
multiculturalism	doctrine
testis	gonad
vanda	orchid
theophylline	bronchodilator
evacuee	migrant
heterozygote	zygote
peroxidase	oxidase
stogie	cigar
yugoslavian	european
gunpowder	explosive
alchemist	intellectual
dard	indic
turnstone	plover
phenomenology	doctrine
duma	legislature
darner	mender
fluorine	halogen
glycogen	polysaccharide
desipramine	tricyclic
involucre	bract
lobbyist	persuader
mycobacteria	eubacteria
spiritualist	psychic
neutrophil	leukocyte
nitrazepam	benzodiazepine
parsons	clergyman
streptomyces	actinomycete
braggart	egotist
solan	gannet
pathfinder	expert
sodalite	mineral
friar	religious
greengrocer	grocer
sophistry	fallacy
godwit	shorebird
tipster	adviser
kidnapper	captor
litterbug	slob
aniline	amine
oncidium	orchid
persecutor	oppressor
semiautomatic	pistol
naphthalene	hydrocarbon
chewa	african
cafeteria	restaurant
spillway	conduit
teenager	juvenile
cocci	eubacteria
bosun	mariner
junta	clique
colchicine	analgesic
effeminacy	femininity
witchcraft	sorcery
norman	frenchman
barkeeper	employee
countertop	tabletop
napalm	gasoline
laudanum	opiate
penitence	compunction
ferryman	boatman
wangler	deceiver
placental	mammal
dissertation	treatise
armagnac	brandy
esotropia	strabismus
marauder	attacker
manslaughter	homicide
forsythia	shrub
ascot	cravat
javelina	peccary
jr	son
miscreant	wrongdoer
insulin	hormone
prednisone	glucocorticoid
knockabout	sloop
plunderer	thief
recitalist	soloist
stakeholder	neutral
druze	disciple
sulfonamide	antibacterial
blancmange	dessert
methuselah	oldster
echinococcus	tapeworm
aardvark	placental
yahoo	rustic
kanamycin	antibiotic
matai	conifer
agoraphobia	phobia
springbok	gazelle
teashop	restaurant
billboard	signboard
kyanite	mineral
dracaena	agave
phosphine	pesticide
folktale	narrative
plectranthus	houseplant
ductility	malleability
sagebrush	subshrub
hirsutism	hairiness
immunoglobulin	antibody
purchaser	customer
nad	coenzyme
libyan	african
follicle	vesicle
fumigant	chemical
bookkeeper	accountant
zairean	african
styrofoam	polystyrene
murderer	criminal
modeller	creator
reallocate	allocate
moose	deer
lactose	disaccharide
blackwater	disease
newlywed	spouse
nephrite	amphibole
hymie	jew
telefilm	movie
archaeologist	anthropologist
urethane	ester
polytheist	theist
han	dynasty
earring	jewelry
ivy	vine
repentance	compunction
birdbrain	misfit
sycophancy	obsequiousness
bestower	benefactor
plugger	advertiser
auklet	auk
singlet	undergarment
oystercatcher	shorebird
hcfc	chlorofluorocarbon
amati	violin
czechoslovakian	european
salesperson	employee
paraquat	herbicide
amoxicillin	penicillin
emery	mineral
muggins	simpleton
minium	oxide
laparoscope	endoscope
orpiment	mineral
demagoguery	entreaty
psychotherapist	therapist
extraversion	sociability
methamphetamine	amphetamine
mara	rodent
trekker	traveler
alexia	aphasia
erythromycin	antibiotic
coverlet	bedspread
chloroplast	plastid
smallholder	farmer
tatu	armadillo
teratology	embryology
segregationist	bigot
stoner	attacker
eft	newt
realgar	mineral
thrombolytic	pharmaceutical
kibitzer	meddler
confidante	confidant
sociability	sociality
skateboarder	skater
criminology	sociology
laetrile	amygdalin
amylase	enzyme
human	hominid
novocain	procaine
schizophrenic	psychotic
maharaja	prince
pfc	fluorocarbon
interception	prevention
bluestone	sandstone
thankfulness	gratitude
annoy	displease
buckyball	fullerene
racialist	bigot
prosthodontics	dentistry
juror	panelist
choirboy	chorister
heparin	anticoagulant
dreadnaught	battleship
merchandise	commodity
counterespionage	counterintelligence
infrequency	scarcity
usurer	lender
salmi	ragout
bufferin	aspirin
alienist	psychiatrist
pilferage	larceny
radioisotope	isotope
blowhard	egotist
crinoid	echinoderm
jaywalker	pedestrian
levodopa	dopa
carnosaur	theropod
pita	flatbread
patriot	national
monotheism	theism
gramps	grandparent
chlorobenzene	hydrocarbon
augite	mineral
horticulturist	expert
legality	lawfulness
rote	memorization
chlorpyrifos	organophosphate
iaa	auxin
mandola	mandolin
perspire	excrete
overrate	misjudge
octogenarian	oldster
blintz	pancake
lakota	sioux
gazelle	antelope
hydroxymethyl	methyl
fencer	combatant
cfc	pollutant
ripsaw	handsaw
shang	dynasty
sundial	timepiece
greensand	sandstone
calorimetry	measurement
malayan	asian
aneroid	barometer
york	dynasty
prophylaxis	prevention
luo	nilotic
monograph	treatise
brigand	thief
commercial	ad
midshipman	cadet
whirlwind	windstorm
kudu	antelope
potentiation	synergy
arminianism	protestantism
tycoon	businessman
shearwater	petrel
junker	prussian
catalase	enzyme
subshrub	shrub
paleobotany	paleobiology
masdevallia	orchid
docility	tractability
kali	shrub
directive	pronouncement
guaranty	collateral
brainiac	intellectual
dingbat	simpleton
aflatoxin	mycotoxin
interment	funeral
collectivist	socialist
asiatic	inhabitant
polygamist	spouse
fulmar	petrel
playhouse	plaything
prosthetist	expert
tzar	sovereign
tamarisk	shrub
ndebele	nguni
legate	emissary
jemmy	crowbar
staphylococci	coccus
skua	jaeger
reliquary	container
maltreatment	mistreatment
triennial	anniversary
mica	mineral
manageability	tractability
philodendron	liana
microscope	magnifier
metronome	pendulum
methodism	protestantism
inventor	creator
rancher	farmer
digestibility	edibility
burglar	thief
glucocorticoid	corticosteroid
cloth	artifact
calliandra	shrub
eff	copulate
curmudgeon	oldster
warder	lawman
mythologist	expert
aerialist	acrobat
abbe	abbot
mandrill	baboon
contrarian	investor
hothouse	greenhouse
emotionality	trait
septicaemia	sepsis
hnd	diploma
linseed	oilseed
posterboard	cardboard
cretin	simpleton
aleurone	protein
stowaway	passenger
adjuvant	additive
electorate	citizenry
interviewer	inquirer
arteriosclerosis	sclerosis
provera	progestin
psalmist	composer
pinata	plaything
wailer	mourner
ethnographer	anthropologist
amputee	unfortunate
vasopressin	hormone
basotho	african
cheater	wrongdoer
acolyte	clergyman
dapsone	antibacterial
parcheesi	pachisi
synchrotron	cyclotron
kookaburra	kingfisher
aphorism	maxim
prospector	miner
lobotomy	psychosurgery
couturier	creator
merchant	businessperson
demeaning	humiliate
hatter	merchant
paralysis	dysfunction
prosthesis	corrective
brahma	bovine
chub	cyprinid
aflatoxin	bioweapon
beaut	exemplar
clematis	vine
amygdalin	glucoside
cheapskate	miser
lycian	anatolian
perfluorocarbon	fluorocarbon
herm	statue
sanskrit	indic
berlin	limousine
caspase	protease
matcher	mediator
blackmailer	criminal
antiproton	nucleon
nebbish	simpleton
trader	merchant
alopecia	baldness
legislator	lawgiver
showpiece	curio
punster	humorist
hydrography	oceanography
dextrose	glucose
eosin	fluorescein
bullhorn	loudspeaker
catalepsy	hypersomnia
saiga	antelope
nightgown	nightwear
hadj	pilgrimage
ergosterol	sterol
carmelite	friar
ogee	cyma
haoma	vine
haemodialysis	dialysis
businessman	businessperson
layperson	commoner
architect	creator
outlawry	illegality
psychedelia	subculture
cognac	brandy
palter	misinform
pistol	firearm
hippeastrum	amaryllis
steakhouse	restaurant
pedestrian	traveler
magnesite	mineral
placekicker	kicker
belarusian	slavic
inadmissibility	unacceptability
catamaran	sailboat
malti	semitic
disenchantment	edification
abolitionism	doctrine
contraband	merchandise
neoconservatism	conservatism
undershirt	undergarment
spiracle	orifice
edutainment	entertainment
motorway	highway
shaitan	genie
formalisation	systematization
haycock	haystack
naysayer	obstructionist
dioxin	hydrocarbon
inrush	inflow
ratepayer	taxpayer
alcazar	fortress
imipramine	tricyclic
casanova	womanizer
nuclease	enzyme
greenbrier	vine
yarrow	achillea
arbutus	shrub
abeyance	inaction
thermometry	measurement
autosome	chromosome
biologist	scientist
doula	assistant
thornbill	hummingbird
statistic	datum
hfc	fluorocarbon
maidenhair	fern
shigellosis	dysentery
muncher	chewer
incinerator	furnace
hartebeest	antelope
unbox	unpack
mignonette	reseda
phthisis	tuberculosis
agitprop	propaganda
tunicate	chordate
sanderling	sandpiper
antibiotic	antibacterial
revivalist	preacher
ripper	murderer
slaw	salad
igbo	nigerian
irrationality	insanity
minor	juvenile
mammal	vertebrate
mandamus	writ
amharic	semitic
oxytocin	hormone
badmouth	defame
vendor	merchant
geophysics	geology
propinquity	nearness
trichinosis	myositis
merchandiser	businessperson
turncoat	quitter
baryon	fermion
doofus	simpleton
sutler	supplier
barberry	shrub
vendee	customer
hydrocortisone	corticosteroid
gangplank	footbridge
phytochemical	chemical
borax	mineral
hopeful	applicant
bennie	amphetamine
courtship	entreaty
shah	sovereign
graybeard	oldster
anorthite	plagioclase
skewness	asymmetry
ungulate	placental
chlorite	mineral
pillager	thief
ige	immunoglobulin
centenary	anniversary
balking	disobey
dovecote	birdhouse
ilk	kind
nucleoprotein	protein
saran	thermoplastic
starfish	echinoderm
septuagenarian	oldster
impetuosity	impulsiveness
eurodollar	eurocurrency
bandana	handkerchief
authenticity	credibility
revivalism	evangelicalism
congregant	churchgoer
protegee	protege
childbearing	parturition
albite	plagioclase
faubourg	suburb
stickler	martinet
sorceress	sorcerer
addax	antelope
laird	landowner
letdown	dissatisfaction
moisture	wetness
noradrenaline	vasoconstrictor
doorpost	jamb
chalcopyrite	mineral
disillusioned	disappoint
astronomer	physicist
helpmate	spouse
kenning	trope
phytotherapy	therapy
qing	dynasty
carbohydrate	macromolecule
astrophysics	astronomy
rhabdomyosarcoma	sarcoma
penury	poverty
hitchhiker	passenger
maser	amplifier
showboat	steamboat
valois	dynasty
quinine	antimalarial
monism	doctrine
babinski	reflex
northman	european
emollient	toiletry
wannabe	applicant
metasequoia	conifer
inscrutability	incomprehensibility
puppeteer	performer
temazepam	benzodiazepine
potash	lye
taconite	chert
pinko	collectivist
zeaxanthin	carotenoid
rareness	scarcity
polymyositis	myositis
antimalarial	antiprotozoal
housekeeper	domestic
handgun	firearm
curandero	therapist
callousness	insensitivity
levite	jew
womaniser	libertine
centenarian	oldster
lumberyard	workplace
compsognathus	theropod
mortgagor	debtor
chicano	mexican
thievery	felony
mercer	trader
promethazine	antihistamine
methicillin	penicillin
samara	achene
musketeer	infantryman
myosin	globulin
populism	doctrine
maltose	disaccharide
glyceraldehyde	aldehyde
jakes	outbuilding
lemming	rodent
tercentenary	anniversary
acidophilus	probiotic
recco	reconnaissance
pathogen	microorganism
laggard	idler
apostate	quitter
bronchiolitis	bronchitis
liman	lagoon
ranitidine	antacid
vaulter	athlete
offeror	benefactor
ravine	valley
bolete	fungus
azithromycin	antibacterial
pinot	vinifera
tsar	sovereign
organic	fertilizer
razorbill	auk
ethnography	anthropology
seismologist	geophysicist
reflectance	coefficient
neuroma	tumor
fibber	liar
probable	applicant
stealer	criminal
ambler	pedestrian
conveyancer	lawyer
coville	shrub
perihelion	periapsis
deadbeat	debtor
pone	cornbread
photographer	artist
clergy	priesthood
ropewalk	workplace
phencyclidine	hallucinogen
chlorpromazine	phenothiazine
firebox	furnace
globetrotter	cosmopolitan
coolie	asian
screenwriter	scriptwriter
coprolite	droppings
gratefulness	gratitude
minyan	quorum
fleming	belgian
cv	summary
spaniard	european
octahedron	polyhedron
fascista	fascist
fluorspar	mineral
fiberboard	wallboard
artfulness	disingenuousness
insecticide	pesticide
ballade	poem
mesenchyme	mesoderm
prairie	grassland
earthman	inhabitant
halon	pollutant
nucleolus	organelle
sikh	disciple
microbiologist	biologist
agility	gracefulness
pinky	minimus
qin	dynasty
periodontics	dentistry
dudgeon	indignation
smiley	emoticon
paralegal	paraprofessional
librium	benzodiazepine
vaudevillian	performer
curare	alkaloid
skeptic	intellectual
cyanobacteria	eubacteria
vertebrate	chordate
wildfire	conflagration
muskat	vinifera
marmot	rodent
sudanese	african
histamine	amine
metformin	antidiabetic
buckminsterfullerene	fullerene
goldstone	sunstone
dunce	stupid
plagioclase	feldspar
strophe	stanza
collectible	curio
pinkie	minimus
allele	gene
letterman	athlete
outhouse	outbuilding
delft	earthenware
listeria	eubacteria
satanism	sorcery
brae	hillside
bulbul	nightingale
granary	storehouse
ampicillin	penicillin
publican	bartender
geophysicist	geologist
exonuclease	nuclease
hermaphrodite	bisexual
macrophage	phagocyte
desperado	criminal
mozambican	african
canoeist	boatman
rhesus	macaque
testicle	gonad
freeware	software
hemodialysis	dialysis
gruel	porridge
kurd	asian
crowberry	shrub
wrestler	combatant
charlatan	deceiver
repairman	mender
tia	ischemia
hypermarket	supermarket
calamine	mineral
codified	systematize
goner	desperate
druse	disciple
paramedic	paraprofessional
goatherd	herder
rwandan	african
yeller	communicator
stibnite	mineral
perfectionist	compulsive
attacker	wrongdoer
aloe	succulent
transferase	enzyme
anthophyllite	amphibole
hawkmoth	moth
thunderer	noisemaker
durabolin	androgen
hayseed	rustic
astrometry	astronomy
autobiography	biography
chutney	condiment
highbrow	intellectual
fakir	muslim
benzedrine	amphetamine
hypnotist	psychologist
oxidoreductase	enzyme
cooperativeness	tractability
dunderhead	stupid
wei	dynasty
poliovirus	enterovirus
tenia	headband
godson	godchild
corncrake	crake
cirio	candlewood
siltstone	sandstone
huaraches	sandal
nepalese	asian
araucaria	conifer
ishmael	unfortunate
cardia	orifice
paranoiac	psychotic
dolt	simpleton
airdrome	airfield
cutlass	sword
ribose	carbohydrate
rajah	aristocrat
ukrainian	slavic
moron	simpleton
cornpone	cornbread
psychic	occultist
kirsch	brandy
enzymology	biochemistry
ephedrine	alkaloid
geometer	mathematician
anisette	liqueur
windsor	dynasty
cation	ion
satirist	humorist
mescaline	hallucinogen
haberdasher	merchant
sphalerite	mineral
ocotillo	candlewood
unmanned	faze
aspirin	analgesic
veld	grassland
illuminance	luminosity
itraconazole	antifungal
junco	finch
revelry	merrymaking
tourist	traveler
gorse	shrub
filariasis	disease
silviculture	forestry
beigel	bun
cliche	truism
magnesia	mineral
saguaro	cactus
pentobarbital	barbiturate
diazepam	benzodiazepine
paramedical	paraprofessional
pachinko	pinball
serzone	antidepressant
positioner	actuator
tartuffe	hypocrite
khalifah	muslim
phenergan	antiemetic
antipope	pope
bronchopneumonia	pneumonia
scarred	deface
conciliator	mediator
reptilian	vertebrate
astronaut	traveler
polygyny	polygamy
hdl	lipoprotein
theatricality	artificiality
slacker	idler
sheriff	lawman
briony	vine
neomycin	antiseptic
ceftriaxone	cephalosporin
heparin	polysaccharide
stockroom	storeroom
khalif	muslim
cabinetry	carpentry
recantation	disavowal
tripoli	limestone
cpa	accountant
sufi	muslim
popover	muffin
adventist	christian
naris	orifice
trichloroethylene	ethylene
penlight	flashlight
kummel	liqueur
perjury	misdemeanor
barkeep	employee
mycoplasma	eubacteria
landlord	landowner
gumma	granuloma
chiropractor	therapist
coleslaw	salad
dinky	locomotive
originator	creator
prole	commoner
broadness	width
orography	geology
creationism	doctrine
adrenalin	neurotransmitter
thursday	weekday
abjuration	disavowal
martinet	authoritarian
goer	migrant
picador	bullfighter
archdeacon	clergyman
