dingbat	simpleton
lexis	cognition
postman	deliveryman
calliandra	shrub
phospholipid	lipid
psychopharmacology	pharmacology
antiquary	expert
highflyer	achiever
neomycin	antiseptic
bistro	restaurant
bedspread	bedclothes
sirocco	windstorm
pseudoscience	fallacy
illiterate	ignoramus
hindi	sanskrit
glucophage	antidiabetic
nitroglycerin	vasodilator
trekker	traveler
naturist	individualist
croat	slav
seigneur	overlord
collagenase	enzyme
kurd	asian
admissibility	acceptability
iroquoian	amerind
eurodollar	eurocurrency
worrier	spoilsport
milliner	merchant
pimple	acne
orthodontist	dentist
emancipator	liberator
plagiarist	thief
hesitance	diffidence
oceanographer	scientist
adulation	flattery
charr	salmonid
paranoia	psychosis
picador	bullfighter
trustworthiness	trait
troubadour	singer
alcoholic	drunkard
lunacy	insanity
qin	dynasty
elastase	enzyme
reductase	enzyme
rnase	transferase
phenylephrine	adrenergic
murderer	criminal
centerfold	foldout
fertiliser	chemical
postmistress	postmaster
heliotrope	chalcedony
cassock	vestment
cuboid	parallelepiped
sedition	misdemeanor
carnelian	chalcedony
psychoanalyst	psychiatrist
chaffinch	finch
insulin	hormone
contiguity	nearness
han	dynasty
propinquity	nearness
landman	inhabitant
preemie	neonate
playschool	preschool
moxie	fortitude
laparoscopy	laparotomy
microbrewery	brewery
cigarillo	cigar
bot	larva
cerussite	mineral
layman	commoner
menshevik	socialist
dexamethasone	corticosteroid
kudu	antelope
stagehand	employee
epicureanism	doctrine
salsa	condiment
tricyclic	antidepressant
emigrant	migrant
caragana	shrub
coronary	thrombosis
helpmate	spouse
cytokine	protein
maltreatment	mistreatment
myosin	globulin
tritium	hydrogen
disgruntlement	discontentment
burster	explosive
chloroplast	plastid
recluse	loner
wahhabi	muslim
haircut	hairdo
outlawry	illegality
epicene	bisexual
cheatgrass	brome
iga	immunoglobulin
pauperism	poverty
hydrology	geophysics
architect	creator
alkalinity	ph
fiberboard	wallboard
cargo	merchandise
sniper	marksman
trinitarianism	protestantism
treponema	spirochete
cattleya	orchid
carriageway	roadway
stockcar	boxcar
chevy	annoy
bayer	analgesic
healthfulness	wholesomeness
nitrazepam	benzodiazepine
clematis	vine
herm	statue
cannery	factory
brewpub	brewery
winterberry	holly
emigre	migrant
senator	legislator
pion	meson
gran	grandparent
tunicate	chordate
aerolite	meteorite
guerilla	warrior
triazolam	benzodiazepine
seb	bioweapon
housemaster	headmaster
samara	achene
kummel	liqueur
spaceman	traveler
tercentenary	anniversary
daycare	childcare
twerp	simpleton
purebred	animal
paucity	scarcity
harijan	outcast
rampart	embankment
saxitoxin	neurotoxin
okapi	giraffe
lycian	anatolian
slater	isopod
diethylstilbestrol	estrogen
algerian	african
infotainment	movie
ringway	highway
teratoma	tumor
atropine	alkaloid
aldose	monosaccharide
futon	mattress
tachograph	tachometer
bikini	swimsuit
liana	vine
kunzite	spodumene
toxoid	antigen
grandma	grandparent
chiropractor	therapist
junto	clique
panadol	analgesic
moonstone	feldspar
barmaid	bartender
garibaldi	blouse
dudgeon	indignation
canyon	ravine
hijinks	merrymaking
sensationalist	publicist
foursquare	rectangle
burglar	thief
paleobotany	paleobiology
disease	illness
beekeeper	farmer
hanuman	langur
sculler	oarsman
saran	thermoplastic
tzar	sovereign
mycologist	botanist
coccus	eubacteria
bart	aristocrat
niece	kinswoman
effendi	turk
aromatherapy	therapy
bryozoan	invertebrate
auklet	auk
uptick	transaction
calvados	brandy
fumigant	chemical
autobiography	biography
fridge	refrigerator
dockyard	waterfront
caterer	supplier
victimisation	mistreatment
bribery	felony
cabinetmaking	carpentry
fibber	liar
medroxyprogesterone	progestin
prophylaxis	prevention
theorist	intellectual
bloodstone	chalcedony
endonuclease	nuclease
skua	jaeger
beaut	exemplar
extenuating	apologize
cloisonne	enamelware
matabele	nguni
musher	traveler
druidism	paganism
neuropsychology	psychology
barrister	lawyer
hedonist	sensualist
expropriation	confiscation
platitude	truism
shiitake	fungus
minoxidil	vasodilator
freedman	freeman
crooner	singer
faience	earthenware
hagiography	biography
tiramisu	dessert
undesirability	bad
fet	transistor
phenolphthalein	laxative
theft	felony
galena	mineral
buyer	customer
sculptress	sculptor
druze	disciple
vaquita	porpoise
itinerant	laborer
lyrebird	passerine
gaelic	celtic
urease	enzyme
ethnology	anthropology
scag	heroin
codeine	antitussive
cpr	resuscitation
silents	movie
silica	oxide
choirboy	chorister
catalepsy	hypersomnia
whitethorn	hawthorn
hayseed	rustic
obnoxiousness	offensiveness
disenchanted	disappoint
cryonics	cryobiology
manslaughter	homicide
decarboxylase	enzyme
rwandan	african
intersex	bisexual
granuloma	tumor
glucosamine	amino
ricin	albumin
ductility	malleability
begum	muslim
kalmia	shrub
chasuble	vestment
galago	lemur
unabridged	dictionary
subluxation	luxation
appeaser	conciliator
jongleur	singer
penicillin	antibiotic
compulsivity	trait
imposter	deceiver
stinginess	trait
seminoma	carcinoma
ebitda	income
letterman	athlete
oxytocin	hormone
adelie	penguin
palaeobiology	paleontology
dendrobium	orchid
metronome	pendulum
mormonism	protestantism
dismemberment	mutilation
importer	businessperson
underclassman	undergraduate
barytes	mineral
laudanum	opiate
monday	weekday
mezcal	cactus
bluejacket	serviceman
monk	religious
colander	strainer
guanosine	nucleoside
charterhouse	monastery
stealer	criminal
sportsman	athlete
lactobacillus	eubacteria
cannister	container
jammies	nightwear
proteinase	enzyme
paleobiology	paleontology
tunisian	african
sweetpea	vine
savanna	grassland
kookaburra	kingfisher
boudoir	bedroom
limonene	terpene
mendacity	untruthfulness
callous	inure
hick	rustic
naris	orifice
haptoglobin	protein
kali	shrub
isomerase	enzyme
wildfire	conflagration
telomerase	enzyme
wheelwright	wright
fenestra	orifice
underclothes	undergarment
skeptic	intellectual
aneroid	barometer
bakeshop	workplace
chlorofluorocarbon	fluorocarbon
oration	oratory
fortuneteller	forecaster
adolescent	juvenile
donjon	stronghold
candlewood	shrub
moniker	appellation
einstein	intellectual
pederasty	paraphilia
millwright	wright
boatswain	mariner
grindstone	sharpener
defendant	litigant
blancmange	dessert
monetarist	economist
winery	distillery
mercer	trader
pinko	collectivist
tailplane	airfoil
paca	rodent
untrustworthiness	trait
sapsucker	woodpecker
ahem	utterance
sycophancy	obsequiousness
copepod	crustacean
hottentot	khoisan
charon	ferryman
archduke	prince
amphotericin	antibiotic
apocalypse	calamity
mycobacterium	eubacteria
kitchenette	kitchen
neurotransmitter	neurochemical
frogman	explorer
rajah	aristocrat
quicklime	oxide
endodontics	dentistry
gabapentin	anticonvulsant
psalmist	composer
juror	panelist
molehill	knoll
luminal	barbiturate
ascomycete	fungus
plaintiff	litigant
tagamet	antacid
monkshood	aconite
annoy	displease
organophosphate	insecticide
nephrite	amphibole
enkephalin	endorphin
inventor	creator
ephedrine	alkaloid
moistness	wetness
grubby	sculpin
poinsettia	spurge
blintz	pancake
emptor	customer
dualism	doctrine
pyrite	mineral
plagioclase	feldspar
intrepidity	courage
napa	crucifer
zooplankton	animal
coffeehouse	restaurant
millerite	mineral
pigman	herder
shylock	lender
amaretto	liqueur
caff	cafe
tetrafluoroethylene	fluorocarbon
kopje	knoll
sigmoidoscopy	endoscopy
spastic	paralytic
lamasery	monastery
ldl	lipoprotein
anion	ion
adept	expert
lumberyard	workplace
opal	mineral
missus	wife
prisoner	unfortunate
quirkiness	unfamiliarity
sculptor	artist
nucleolus	organelle
handbag	container
bedstead	furniture
duelist	adversary
ect	electrotherapy
fabricator	liar
propriety	demeanor
bungler	incompetent
roustabout	mariner
colliery	workplace
verdin	titmouse
tetrapod	vertebrate
pavonia	shrub
humulin	insulin
reactant	chemical
eavesdropper	hearer
plainsman	inhabitant
archduchess	princess
armagnac	brandy
logger	laborer
tsh	hormone
egocentrism	trait
trypsin	enzyme
jnr	son
countersuit	lawsuit
bicentennial	anniversary
phoney	deceiver
broadsword	sword
actinomycete	eubacteria
unmanned	faze
antipsychotic	tranquilizer
faithlessness	infidelity
dinky	locomotive
bindweed	vine
ativan	benzodiazepine
quagga	equine
cheater	wrongdoer
dementia	insanity
brontosaurus	sauropod
cavy	rodent
elavil	tricyclic
potash	lye
mod	adolescent
cyanobacteria	eubacteria
ironclad	warship
strider	pedestrian
quincentenary	anniversary
litoral	seashore
lignin	polymer
necktie	neckwear
marshland	wetland
dissertation	treatise
banksia	shrub
shanny	blenny
protea	shrub
demographer	sociologist
spectrometer	spectroscope
blackbuck	antelope
gabonese	african
acth	hormone
czechoslovak	european
pedlar	seller
rolaids	antacid
shouter	communicator
archdiocese	diocese
nanotube	fullerene
octogenarian	oldster
canape	appetizer
penury	poverty
arethusa	orchid
subdeacon	clergyman
chloroprene	butadiene
glanders	zoonosis
highbrow	intellectual
guinean	african
clergy	priesthood
garbageman	hauler
electrolytic	capacitor
faqir	muslim
littoral	seashore
monotheism	theism
underpants	undergarment
spironolactone	corticosteroid
triennial	anniversary
aniline	amine
cossack	slav
rogaine	vasodilator
spelunker	explorer
olympian	athlete
veld	grassland
ancestress	ancestor
dramamine	antiemetic
strep	eubacteria
alar	chemical
ricin	toxin
kwashiorkor	malnutrition
patriot	national
lensman	artist
churchman	clergyman
perjury	misdemeanor
carrel	alcove
dinnerware	tableware
contrabassoon	bassoon
kimberlite	peridotite
goddaughter	godchild
microtubule	tubule
scot	european
legality	lawfulness
slaw	salad
cellulose	polysaccharide
grandfather	grandparent
jewess	jew
villager	inhabitant
burton	ale
ethnologist	anthropologist
bonemeal	organic
pembroke	corgi
walkaway	victory
eutherian	mammal
aku	kwa
grosbeak	finch
saturday	weekday
corvette	warship
starfish	echinoderm
kerosene	hydrocarbon
gruel	porridge
masonite	fiberboard
kob	waterbuck
dexedrine	amphetamine
promisor	communicator
attacker	wrongdoer
performer	entertainer
lem	spacecraft
companionship	friendship
stridency	timbre
illuminance	luminosity
reliquary	container
businessman	businessperson
muggins	simpleton
skinflint	hoarder
stepfather	stepparent
transferase	enzyme
hanover	dynasty
patisserie	bakery
transact	interact
heparin	polysaccharide
guaranty	collateral
chalcopyrite	mineral
garnet	mineral
geologist	scientist
adulteress	adulterer
buckminsterfullerene	fullerene
tetracycline	antibacterial
arraign	accuse
mathematician	scientist
phosphor	synthetic
maidenhair	fern
ubiquinone	coenzyme
prosthodontics	dentistry
yahoo	rustic
avenger	attacker
berk	stupid
centurion	warrior
parson	clergyman
seaweed	alga
expansionism	doctrine
cytosol	cytoplasm
stanhopea	orchid
rna	polymer
kurdistan	rug
seismologist	geophysicist
mycoplasma	eubacteria
deodorant	toiletry
monasticism	austerity
stockroom	storeroom
glen	valley
icelander	european
epicurean	sensualist
witchery	sorcery
ninny	simpleton
neuroethics	bioethics
synecdoche	trope
paraplegia	paralysis
ergosterol	sterol
policyholder	customer
patentee	inventor
pyroxene	mineral
philanderer	libertine
highroad	highway
schoolmarm	schoolteacher
simile	trope
tadpole	larva
brawler	combatant
revivalism	evangelicalism
kaolinite	mineral
compsognathus	theropod
curare	alkaloid
demeanor	trait
wastrel	prodigal
alienist	psychiatrist
salesman	salesperson
accuser	disputant
epinephrine	neurotransmitter
nicotine	alkaloid
histamine	amine
arabic	semitic
punster	humorist
durabolin	androgen
grisaille	chiaroscuro
arsonist	criminal
rani	aristocrat
hewer	laborer
atavism	recurrence
aphorism	maxim
manichaean	disciple
metaphor	trope
blah	grandiosity
adrenaline	neurotransmitter
liberator	benefactor
neurobiologist	biologist
tripoli	limestone
jadeite	mineral
bitumen	hydrocarbon
spurge	shrub
ascot	cravat
freeholder	landowner
outcast	unfortunate
sybarite	sensualist
archdeacon	clergyman
nonproliferation	prevention
phlogopite	mica
volcanology	geophysics
pharmacokinetics	pharmacology
mandola	mandolin
worse	bad
artfulness	disingenuousness
bahai	disciple
calvinism	protestantism
pulpwood	softwood
switchblade	pocketknife
proteomics	genetics
croatian	slav
relaxin	hormone
furze	shrub
bullfinch	finch
shanghai	kidnap
brakeman	trainman
kinase	enzyme
epiphyllum	cactus
chopstick	tableware
canonization	sanctification
pastureland	grassland
transgene	gene
carrell	alcove
rabies	zoonosis
bvd	underwear
mesothelioma	carcinoma
bumpkin	rustic
ulster	greatcoat
pavlova	dessert
terrarium	vivarium
nazism	fascism
vendor	merchant
commonplace	truism
pappus	calyx
mignonette	reseda
macrobiotics	dietetics
bulbul	nightingale
elegy	poem
methuselah	oldster
yokel	rustic
formaldehyde	aldehyde
trilateral	polygon
theophylline	bronchodilator
seller	merchant
redeployment	deployment
microscopist	scientist
goy	christian
reserpine	antihypertensive
roquefort	bleu
polychaete	annelid
aminotransferase	transferase
spermatozoon	gamete
lithops	succulent
klutz	stupid
guanaco	llama
shigellosis	dysentery
cleric	clergyman
sadomasochism	masochism
concubinage	cohabitation
dysphoria	discontentment
shallon	shrub
schnauzer	terrier
hoodlum	criminal
haoma	vine
trichinosis	myositis
modeller	creator
hollander	european
jakes	outbuilding
entombment	funeral
coadjutor	assistant
ranee	aristocrat
tylenol	analgesic
servility	submissiveness
silverback	gorilla
adiposity	fatness
hippodrome	stadium
anthurium	houseplant
utilitarianism	doctrine
thermocouple	thermometer
enzyme	protein
cyclooxygenase	enzyme
shareholder	investor
fakir	muslim
expat	absentee
lobbyist	persuader
jessamine	jasmine
populism	doctrine
comply	obey
displeasure	dissatisfaction
executrix	executor
rustic	commoner
neurotoxin	toxin
cager	athlete
molasses	syrup
gat	pistol
larceny	felony
cardia	orifice
cpa	accountant
defamer	detractor
cravat	neckwear
zhou	dynasty
shang	dynasty
yugoslav	european
impetuosity	impulsiveness
ketoacidosis	acidosis
beduin	nomad
stacker	laborer
pogrom	persecution
griot	narrator
parallelogram	quadrilateral
polypeptide	peptide
encephalartos	cycad
wiz	expert
galliano	liqueur
intelligibility	comprehensibility
few	elite
gramps	grandparent
ambler	pedestrian
hudood	shariah
psychotherapist	therapist
chlorpyrifos	organophosphate
freeloader	borrower
fibreboard	wallboard
bittern	heron
courier	traveler
monosaccharide	carbohydrate
euglena	protozoan
noncombatant	serviceman
hemangioma	angioma
hawthorn	shrub
megalomaniac	egotist
nicotine	vasoconstrictor
homophone	homonym
ineffectiveness	powerlessness
russet	homespun
heterozygote	zygote
shunter	locomotive
persecutor	oppressor
farmer	creator
lusatian	slavic
tuxedo	formalwear
scion	descendant
warner	communicator
cirio	candlewood
migrant	traveler
fogey	oldster
wainwright	wright
neuroleptic	tranquilizer
pedestrian	traveler
ed	dysfunction
plasminogen	plasmin
maharani	princess
prorogation	discontinuance
meany	oppressor
broadsheet	ad
specifier	intellectual
thornbill	hummingbird
camelia	shrub
bitterroot	wildflower
abridgment	summary
adrenalin	hormone
grenadine	syrup
ilmenite	mineral
cottier	serf
astrometry	astronomy
ddt	insecticide
zori	sandal
thiopental	barbiturate
zoroastrian	disciple
sentry	watchman
hotshot	expert
ocotillo	candlewood
vervet	guenon
astatine	halogen
embalmer	mortician
autostrada	expressway
talkie	movie
albite	plagioclase
nystatin	antibiotic
lorikeet	lory
noradrenaline	vasoconstrictor
glasswork	tableware
starship	spacecraft
saiga	antelope
convolvulus	vine
anoxia	hypoxia
chitin	polysaccharide
edo	nigerian
hfc	fluorocarbon
octagon	polygon
spiracle	orifice
nihil	nothing
bullhorn	loudspeaker
thistledown	pappus
amati	violin
icosahedron	polyhedron
thrombophlebitis	phlebitis
signalman	signaler
exclusiveness	snobbery
intricacy	complexity
ming	dynasty
hakeem	muslim
gazelle	antelope
malawian	african
slyness	shrewdness
minoan	cretan
wildflower	angiosperm
camarilla	clique
central	workplace
aardvark	placental
cyperus	cyperaceae
codify	systematize
advertorial	ad
egret	heron
nutria	rodent
betaine	alkaloid
tortilla	pancake
bursar	treasurer
hitchhiker	passenger
enforcer	assistant
cimetidine	antacid
cottonseed	oilseed
merchandiser	businessperson
explosive	chemical
peroxidase	oxidase
hamster	rodent
collectable	curio
mandrill	baboon
reacquaint	familiarize
verticillium	fungus
cartwright	wright
pectin	cellulose
functionality	practicality
gamba	viol
heparin	anticoagulant
dervish	fakir
aspirin	analgesic
rubella	measles
gatecrasher	intruder
huguenot	calvinist
nullah	valley
gambian	african
parathion	insecticide
acrolein	aldehyde
shlock	merchandise
meccano	plaything
allele	gene
carnosaur	theropod
veracity	truthfulness
shareware	software
trichloroethane	ethylene
lombard	european
chewa	african
brainiac	intellectual
winger	athlete
hibiscus	mallow
litterbug	slob
letterhead	stationery
vendee	customer
rotenone	insecticide
stockman	farmer
frequenter	customer
neckerchief	kerchief
inculcation	indoctrination
emeritus	retiree
reformism	doctrine
pedicab	tricycle
disillusioned	disappoint
hydrocortisone	corticosteroid
platelet	protoplasm
immigrant	migrant
longlegs	shorebird
bhutanese	asian
psilocybin	hallucinogen
carborundum	abrasive
christ	savior
cosmetic	toiletry
horticulturist	expert
pureblood	animal
seconal	barbiturate
coverlet	bedspread
congressman	legislator
fluorite	mineral
birdbrain	misfit
mujahid	muslim
gradual	antiphon
gangster	criminal
gypsum	mineral
decorum	propriety
owlet	owl
caduceus	insignia
trinidadian	inhabitant
calorimetry	measurement
embezzler	deceiver
rhododendron	shrub
banality	truism
dale	valley
monoplane	airplane
clostridia	eubacteria
telefilm	movie
preacher	clergyman
moa	ratite
igm	immunoglobulin
paraphernalia	equipment
literati	intelligentsia
acidophilus	lactobacillus
exocrine	gland
flan	dessert
overstress	overstate
gaillardia	wildflower
flavin	ketone
goldenrod	wildflower
earthstar	fungus
aussie	inhabitant
airliner	airplane
follicle	vesicle
cortisol	corticosteroid
alexia	aphasia
pentaerythritol	vasodilator
cutthroat	murderer
layperson	commoner
lipid	macromolecule
underskirt	undergarment
lawbreaker	criminal
tornillo	mesquite
glucosamine	glucose
gnu	antelope
thievery	felony
dunnock	accentor
instructor	educator
solan	gannet
peccadillo	misbehavior
earring	jewelry
spermatogenesis	gametogenesis
bookman	intellectual
vancomycin	antibiotic
percolator	coffeepot
interstate	highway
atropine	antidote
itraconazole	antifungal
dane	european
papain	enzyme
commie	socialist
emotionalism	trait
hadj	pilgrimage
fedayeen	paramilitary
gritstone	sandstone
puffery	flattery
switchboard	central
tuesday	weekday
strychnine	alkaloid
inosine	nucleoside
yob	attacker
wolfsbane	aconite
diamondback	rattlesnake
bowman	expert
looter	thief
stowaway	passenger
disloyalty	infidelity
bobby	policeman
paymaster	payer
scottie	terrier
subcontinent	landmass
akkadian	semitic
demiurge	deity
hostage	prisoner
longshoreman	laborer
human	hominid
dle	lupus
nostoc	cyanobacteria
sheetrock	plasterboard
hausen	sturgeon
nobody	commoner
arminianism	protestantism
easel	tripod
saviour	benefactor
dard	indic
microelectronics	electronics
derris	shrub
geographer	expert
strad	violin
misogynist	misanthrope
salmi	ragout
shipyard	workplace
stomper	pedestrian
butadiene	hydrocarbon
reprisal	retaliation
disfranchisement	discontinuance
egalitarianism	doctrine
staffer	employee
prodigal	consumer
stayer	animal
tannery	workplace
chrysotile	asbestos
minium	oxide
exoticism	foreignness
recrudescence	outbreak
neosporin	antibacterial
pleuropneumonia	pleurisy
tatu	armadillo
orthodontia	dentistry
orography	geology
schizophrenia	psychosis
faubourg	suburb
diphenhydramine	antihistamine
obstinate	persevere
meningoencephalitis	meningitis
purist	pedant
khalif	muslim
hoaxer	troublemaker
badmouth	defame
methotrexate	immunosuppressant
catclaw	shrub
waterbuck	antelope
buckyball	fullerene
metasequoia	conifer
minicab	minicar
corticotropin	hormone
maxillaria	orchid
coleslaw	salad
bolivia	canasta
carthaginian	african
nilgai	antelope
pasteboard	cardboard
gotterdammerung	myth
indiscipline	trait
ballade	poem
springbok	gazelle
phytochemical	chemical
cablegram	telegram
ayah	domestic
townes	physicist
maltose	disaccharide
ephedra	shrub
ale	beer
hypoplasia	dysplasia
mac	raincoat
lumbago	backache
steakhouse	restaurant
maestro	artist
cutler	trader
wednesday	weekday
hytrin	antihypertensive
salesperson	employee
balking	disobey
taconite	chert
shearwater	petrel
profanity	utterance
organic	fertilizer
martinet	authoritarian
plantsman	expert
ennui	dissatisfaction
lunchroom	restaurant
aspirin	salicylate
eubacteria	bacteria
cameroonian	african
softener	chemical
dovecote	birdhouse
congresswoman	legislator
turfan	tocharian
culprit	wrongdoer
daydreamer	idler
thymosin	hormone
pilferage	larceny
ropewalk	workplace
mesentery	peritoneum
seaside	seashore
khufu	pharaoh
pyracantha	shrub
overstay	bide
sadomasochism	sadism
revers	lapel
reproducibility	dependability
rima	orifice
sociopath	neurotic
fabian	socialist
herbivore	animal
moroccan	african
carthusian	monk
marketer	merchant
hapsburg	dynasty
dexterity	adeptness
nucleoprotein	protein
licensee	retailer
polytheist	theist
rosebush	shrub
hirer	employer
unreason	insanity
triggerman	murderer
biophysicist	physicist
wrestler	combatant
imbecile	simpleton
crassness	insensitivity
malign	defame
milkmaid	farmhand
wei	dynasty
hitman	murderer
croissant	bun
realgar	mineral
chemotherapy	therapy
naturopath	therapist
bra	undergarment
eritrean	ethiopian
nandu	ratite
inrush	inflow
spyware	software
orthoclase	feldspar
haemodialysis	dialysis
plugboard	central
carolingian	sovereign
oca	oxalis
milker	cattle
serjeant	barrister
tenia	headband
intuit	grok
foetus	vertebrate
realness	actuality
lysozyme	enzyme
greenshank	sandpiper
totalitarian	disciple
aloe	succulent
stratigraphy	geology
cowry	gastropod
atropine	antispasmodic
grevillea	shrub
softie	weakling
probiotic	bacteria
pheochromocytoma	tumor
wombat	marsupial
rundown	summary
creditworthiness	trustworthiness
harvestman	arachnid
monastic	religious
microbe	microorganism
merchant	businessperson
dosimetry	measurement
tailcoat	formalwear
aquarium	vivarium
wailer	mourner
seismology	geophysics
streptomyces	actinomycete
leatherneck	serviceman
nadp	coenzyme
plaything	artifact
materiel	equipment
fishmonger	trader
vaulter	athlete
dormouse	rodent
haiku	poem
shabu	amphetamine
pahoehoe	lava
voter	citizen
ecologist	biologist
craven	coward
nightdress	lingerie
cryolite	mineral
onyx	chalcedony
zairean	african
prescribe	inflict
compote	dessert
hangman	executioner
hysteric	neurotic
psa	protein
mailman	deliveryman
narc	lawman
patrolman	lawman
flatus	reflex
swordsman	combatant
centipede	arthropod
synopsis	summary
dualist	disciple
mifepristone	abortifacient
ribavirin	antiviral
metonymy	trope
mineralogy	geology
demerol	narcotic
geophysicist	geologist
reflectance	coefficient
rentier	investor
neomycin	antibiotic
cassie	acacia
presbyopia	hyperopia
recalcitrance	intractability
prevue	ad
cataloger	librarian
grandparent	forebear
mauritanian	african
compatriot	national
edutainment	entertainment
idolised	adore
pantry	storeroom
breeder	stockman
fuller	workman
waffler	communicator
neuroscience	neurobiology
iodide	halide
giraffe	ruminant
trh	hormone
malachite	mineral
wastebasket	container
purposefulness	meaningfulness
doorpost	jamb
pernod	liqueur
palliate	apologize
astrologist	forecaster
desperate	unfortunate
cartographer	geographer
screenwriter	scriptwriter
flaxseed	oilseed
leaver	migrant
siskin	finch
miser	hoarder
hypnotised	sedate
grifter	deceiver
burgess	englishman
kelt	european
interrogator	inquirer
allophone	phoneme
marc	brandy
antiperspirant	toiletry
skein	hank
plover	shorebird
lindane	insecticide
epinephrine	hormone
welcher	swindler
busker	entertainer
tamarin	marmoset
kangaroo	marsupial
hellion	troublemaker
teen	juvenile
vegan	vegetarian
awol	absentee
rosacea	acne
lothario	womanizer
ripper	murderer
dinka	nilotic
calcination	oxidation
zionist	jew
tantalite	mineral
triglyceride	lipid
parishioner	churchgoer
bandit	thief
innovator	originator
whitetail	deer
bowtie	necktie
purveyor	supplier
evildoer	wrongdoer
conciseness	terseness
gifted	enable
trf	hormone
trinitarian	disciple
musical	movie
earthling	inhabitant
caliph	muslim
internee	prisoner
sesquicentennial	anniversary
listeria	eubacteria
fluor	mineral
urethane	ester
hillbilly	rustic
circe	sorceress
maleate	antidepressant
scrumpy	cider
underrate	misjudge
herbicide	chemical
zithromax	antibacterial
melancholic	depressive
healer	expert
serb	slav
crasher	intruder
strumpet	adulterer
abjuration	disavowal
antiquarian	expert
mynah	starling
psychedelia	subculture
quadriplegia	paralysis
strophe	stanza
placekicker	kicker
fontanelle	orifice
lecithin	phospholipid
wellness	wellbeing
polymerase	enzyme
diatom	alga
loner	individualist
satirist	humorist
novocain	procaine
herbalist	therapist
palter	misinform
luo	nilotic
valois	dynasty
lutheranism	protestantism
gaba	neurotransmitter
sangoma	therapist
whipper	oppressor
monacan	european
aflatoxin	mycotoxin
geophysics	geology
bruneian	bornean
expressway	highway
behaviourist	psychologist
interment	funeral
everyman	commoner
pariah	unfortunate
biopiracy	larceny
unilateralism	doctrine
spacewalker	astronaut
charlotte	dessert
redshank	sandpiper
bacteria	microorganism
couturier	creator
humorist	entertainer
gasworks	workplace
footballer	athlete
tandoor	oven
interregnum	interim
plastid	granule
arcus	cornea
yugoslavian	european
prosecutor	lawyer
claro	cigar
grower	farmer
aunty	kinswoman
sorceress	sorcerer
nagari	syllabary
signaller	communicator
shotgun	firearm
onomastics	lexicology
morphia	analgesic
disturber	troublemaker
ravine	valley
choreographer	creator
ratepayer	taxpayer
acetylcholine	neurotransmitter
cybercafe	cafe
perfectionist	compulsive
guano	organic
cistercian	monk
bookkeeper	accountant
oast	kiln
balladeer	singer
progenitor	ancestor
permeability	porosity
roadworthiness	worthiness
candelabrum	candlestick
overrate	misjudge
cytoplasm	protoplasm
artiste	performer
bohemia	clique
shaitan	genie
eurasian	european
fenland	wetland
byname	appellation
ecclesiastic	clergyman
alarmist	communicator
masai	nilotic
bakehouse	workplace
mineralocorticoid	corticosteroid
dampness	wetness
maven	expert
cymric	brythonic
plateau	highland
monocyte	leukocyte
complainant	litigant
amiodarone	antiarrhythmic
gondolier	boatman
canonisation	sanctification
sleight	adeptness
photocell	transducer
lamisil	antifungal
camaraderie	sociability
constructivist	artist
labourer	workman
gastropod	mollusk
airstrip	airfield
da	prosecutor
deckhand	mariner
staphylococci	coccus
scammer	deceiver
pityriasis	dermatosis
jemmy	crowbar
lhasa	terrier
basotho	african
technophobe	naysayer
drambuie	liqueur
florilegium	anthology
rankle	annoy
astrologer	forecaster
ampicillin	penicillin
adsorbent	sorbent
indispensability	essentiality
obturator	prosthesis
pessimist	skeptic
brae	hillside
couture	dressmaking
leftist	socialist
bacteriologist	biologist
deceiver	wrongdoer
therapist	expert
oxidase	enzyme
alb	vestment
coconspirator	criminal
heliport	airport
bandeau	undergarment
equivocate	misinform
arthropod	invertebrate
broadness	width
episteme	cognition
muntjac	deer
piety	righteousness
aleurone	protein
botanist	biologist
screwup	mismanagement
marauder	attacker
magdalen	sinner
lowbrow	plebeian
stogie	cigar
microflora	microorganism
ornithologist	zoologist
eff	copulate
streptomycin	antibiotic
heathland	barren
troubleshooter	repairman
norman	frenchman
araucaria	conifer
catamaran	sailboat
hdl	lipoprotein
hostelry	hotel
mixologist	employee
kidnapper	captor
gluten	protein
dunderhead	stupid
absentee	traveler
singlet	undergarment
polymyositis	myositis
asiatic	inhabitant
rhombus	parallelogram
commercial	ad
grandmother	grandparent
ergotamine	alkaloid
pratincole	shorebird
frenchman	european
chlorobenzene	hydrocarbon
towhee	finch
heptagon	polygon
magnesia	mineral
hypermedia	multimedia
interviewer	inquirer
ciprofloxacin	antibiotic
mavin	expert
handedness	asymmetry
organdy	muslin
crocked	dirty
maoi	antidepressant
devon	cattle
pentothal	barbiturate
robitussin	expectorant
ukulele	guitar
letdown	dissatisfaction
gloxinia	houseplant
typist	employee
lh	gonadotropin
pollute	dirty
amoxicillin	penicillin
toxicology	pharmacology
savannah	grassland
trivialize	understate
trimaran	sailboat
tamarisk	shrub
zeugma	trope
underwear	undergarment
endotoxin	toxin
disgorgement	reflex
conspectus	summary
doofus	simpleton
scotsman	european
bluffer	deceiver
scheelite	mineral
svengali	persuader
cutlass	sword
obesity	fatness
norepinephrine	catecholamine
demeanour	trait
pastis	liqueur
medoc	bordeaux
pictorial	periodical
airbus	airliner
plugger	advertiser
legionella	bacteria
scholia	marginalia
aflatoxin	bioweapon
liar	deceiver
celt	european
estriol	estrogen
dermatomyositis	myositis
mucuna	shrub
veldt	grassland
essene	jew
mennonite	anabaptist
trematode	flatworm
amharic	semitic
domine	clergyman
endothelium	epithelium
assailant	wrongdoer
urdu	sanskrit
peter	penis
geodesy	geophysics
babinski	reflex
nudist	individualist
goddess	deity
ecoterrorism	terrorism
physiologist	biologist
pandemic	epidemic
monoxide	oxide
parapsychologist	psychologist
cytogenetics	cytology
nightgown	nightwear
pfc	fluorocarbon
irreligion	impiety
minah	starling
somatotropin	hormone
ghat	stairway
grandad	grandparent
collude	interact
congregationalism	protestantism
patroller	watchman
israeli	asian
upbraid	accuse
cytidine	nucleoside
bennie	amphetamine
mediator	negotiator
junco	finch
irrationality	insanity
mammal	vertebrate
hobo	vagrant
posterboard	cardboard
tapeworm	flatworm
gastronome	sensualist
fallacy	misconception
rhomb	parallelogram
infallibility	dependability
penology	criminology
ade	beverage
modeler	creator
malvasia	vinifera
rotavirus	reovirus
sabra	israeli
disinterestedness	impartiality
resoluteness	trait
legate	emissary
showboat	steamboat
gramicidin	antiseptic
scrooge	hoarder
persecution	maltreatment
hatmaker	merchant
pillager	thief
pesticide	chemical
midazolam	benzodiazepine
mylanta	antacid
aesthete	connoisseur
vengeance	retaliation
fulmar	petrel
ribosome	organelle
gigolo	libertine
paleography	archeology
cyberwar	terrorism
nephew	kinsman
curator	custodian
omeprazole	antacid
guestroom	bedroom
oenophile	appreciator
bedroll	bedclothes
bougainvillea	vine
bonobo	chimpanzee
grandnephew	nephew
glomerulonephritis	nephritis
adh	hormone
oriental	asian
thursday	weekday
behaviorist	psychologist
linearity	dimensionality
pistol	firearm
skier	athlete
purchaser	customer
bryony	vine
ribonuclease	transferase
defector	wrongdoer
puffin	seabird
immunogen	antigen
nobelist	laureate
olivine	mineral
pitman	miner
plowman	farmhand
ophthalmia	conjunctivitis
spodumene	mineral
apostate	quitter
virginal	harpsichord
pylorus	orifice
dauphin	prince
thumbnail	fingernail
stupid	simpleton
janitor	custodian
desipramine	tricyclic
flintstone	flint
dumas	legislature
astrophysicist	astronomer
immunotherapy	therapy
frenchwoman	european
annoyed	displease
microscope	magnifier
millenarian	optimist
positioner	actuator
chanal	shrub
gendarme	policeman
guyot	seamount
sputum	mucus
benzedrine	amphetamine
encrypt	encode
sonatina	sonata
segregationist	bigot
menorrhagia	menstruation
trivialise	understate
duma	legislature
sulla	subshrub
mugger	robber
erythropoietin	glycoprotein
mesa	tableland
adrenalin	neurotransmitter
plasterboard	wallboard
cosmetologist	expert
arthroscope	endoscope
ddi	antiviral
cation	ion
artist	creator
instar	arthropod
angevin	frenchman
borax	mineral
larvicide	chemical
clothier	merchant
darner	mender
victrola	gramophone
quin	sibling
wangler	deceiver
bicentenary	anniversary
puppeteer	performer
malti	semitic
zantac	antacid
dunkard	baptist
secularism	doctrine
metronidazole	antiprotozoal
wisent	bison
mica	mineral
emotionality	trait
iguanodon	dinosaur
eosinophil	leukocyte
sambuca	liqueur
amygdalin	glucoside
pub	tavern
forsythia	shrub
atp	nucleotide
myelofibrosis	fibrosis
buddleia	shrub
trilobite	arthropod
cromlech	megalith
juggler	performer
polysaccharide	carbohydrate
colonic	enema
deadbeat	debtor
blaster	workman
radioisotope	isotope
astrology	pseudoscience
capybara	rodent
shopkeeper	merchant
mongol	oriental
caribou	deer
farrier	blacksmith
cachexia	infirmity
prosthetist	expert
dna	polymer
intractability	trait
fsh	gonadotropin
igloo	hovel
polyurethane	polymer
chloroquine	antimalarial
shah	sovereign
extravaganza	entertainment
cv	summary
renin	protease
arsenopyrite	mineral
gonadotropin	hormone
auk	seabird
vaudevillian	performer
supercharger	compressor
adenocarcinoma	carcinoma
tableland	highland
rickettsia	eubacteria
fishpond	pond
promethazine	antihistamine
archaeology	anthropology
speakeasy	barroom
moonshiner	criminal
osteosarcoma	sarcoma
quadrilateral	polygon
wife	spouse
goldfish	cyprinid
bloodworm	polychaete
angioma	angiopathy
protegee	protege
flowerpot	container
workman	employee
evangelicalism	protestantism
gardenia	shrub
popover	muffin
negotiator	communicator
cheroot	cigar
bedouin	nomad
ada	enzyme
insecticide	pesticide
dominie	clergyman
opiate	narcotic
intelligentsia	elite
pawnbroker	lender
periodontist	dentist
interferon	antiviral
magnate	businessman
atherosclerosis	arteriosclerosis
mineralogist	scientist
catecholamine	hormone
phosphorescence	fluorescence
skybox	stadium
stonecutter	quarryman
merchandise	commodity
recantation	disavowal
grappa	brandy
landlord	landowner
acidophilus	probiotic
protein	macromolecule
plausibility	credibility
busybody	meddler
haj	pilgrimage
br	halogen
amitriptyline	tricyclic
bacterium	microorganism
tartuffe	hypocrite
silviculture	forestry
pantyhose	tights
tremolite	asbestos
cabinetry	carpentry
carissa	shrub
charlatan	deceiver
dioxide	oxide
ismaili	disciple
promisee	communicator
limekiln	kiln
rheostat	resistor
sephardi	jew
septicemia	sepsis
sheepherder	herder
freon	chlorofluorocarbon
portico	porch
conquistador	explorer
chicano	mexican
jubilee	anniversary
plunderer	thief
laelia	orchid
contextualism	doctrine
dreadnaught	battleship
pollen	spore
mudder	racehorse
slingshot	plaything
collier	miner
supplier	businessperson
femininity	trait
wimple	headdress
bakery	workplace
portent	augury
amylase	enzyme
stopgap	expedient
dilaudid	analgesic
malayan	asian
navvy	laborer
playboy	hedonist
agronomist	expert
lye	caustic
antivenin	antitoxin
bloodsucker	annelid
phalangist	fascist
hypocrite	deceiver
smegma	sebum
homemaker	wife
pythium	fungus
manger	container
chickadee	titmouse
kudzu	vine
stilton	bleu
sodalite	mineral
souvlaki	kabob
assuredness	composure
hudud	shariah
obsessive	neurotic
reallocate	allocate
sissy	coward
formalization	systematization
infomercial	commercial
peshmerga	kurd
sulfa	antibacterial
paramedic	paraprofessional
trioxide	oxide
retailer	merchant
torturer	oppressor
technophile	fancier
granddaddy	grandparent
sika	deer
andorran	european
arbitrageur	businessman
acrylonitrile	nitrile
housemaid	domestic
warehouseman	workman
selenium	antioxidant
tautog	wrasse
sudafed	vasoconstrictor
junker	prussian
jaywalker	pedestrian
carcinoid	tumor
stoner	attacker
testicle	gonad
paraprofessional	assistant
diazonium	cation
woofer	loudspeaker
miscreant	wrongdoer
yardie	gangster
derogate	disparage
codeine	opiate
borrelia	spirochete
shina	dard
smugness	complacency
marginalize	interact
rowdy	attacker
pinot	vinifera
immortelle	everlasting
ptolemy	dynasty
airscrew	propeller
tnf	cytokine
nightgown	lingerie
deliveryman	employee
smiley	emoticon
trainmaster	trainman
amputee	unfortunate
millpond	pond
dutchman	european
marsh	wetland
alcalde	mayor
pathfinder	expert
humourist	entertainer
windsor	dynasty
mozambican	african
paparazzo	photographer
arles	earnest
diazepam	benzodiazepine
fibroid	fibroma
manoeuvrability	mobility
sooth	truthfulness
york	dynasty
anthropometry	measurement
surrealist	artist
pekan	marten
impersonator	deceiver
ventriloquist	performer
zamia	cycad
testis	gonad
velodrome	racetrack
paranoid	psychotic
geomancer	diviner
batsman	ballplayer
molester	wrongdoer
newswoman	reporter
quesadilla	burrito
espadrille	sandal
colostomy	ostomy
dilemma	perplexity
monograph	treatise
amyloidosis	illness
bph	hyperplasia
parisian	frenchman
octahedron	polyhedron
docudrama	movie
prescribed	inflict
acrylamide	amide
candelabra	candlestick
rex	sovereign
reporter	communicator
agitator	troublemaker
allosaurus	theropod
carpetbagger	opportunist
expositor	intellectual
absolutist	disciple
bilby	bandicoot
congregant	churchgoer
irani	asian
avenged	punish
greensand	sandstone
recce	reconnaissance
stickler	martinet
polygamist	spouse
newlywed	spouse
zoophilia	paraphilia
swineherd	herder
workaholic	compulsive
jingo	patriot
corticosterone	glucocorticoid
glucocorticoid	hormone
sorcerer	occultist
zill	cymbal
instinct	aptitude
phony	deceiver
ironmongery	merchandise
devanagari	syllabary
opsin	protein
wonderment	astonishment
brewpub	restaurant
livestock	placental
spleenwort	fern
museum	depository
lab	workplace
panicle	raceme
hrt	therapy
grandniece	niece
saponin	glucoside
pleader	lawyer
softy	weakling
mirasol	sunflower
bronc	mustang
oxidoreductase	enzyme
perpetrator	wrongdoer
minocycline	tetracycline
pterodactyl	pterosaur
documentary	movie
persuader	communicator
baronet	aristocrat
heckler	troublemaker
parcheesi	pachisi
rareness	scarcity
agitprop	propaganda
kenning	trope
repentance	compunction
adsorption	sorption
impala	antelope
bearcat	civet
sightseer	tourist
ascidian	tunicate
aldosterone	mineralocorticoid
psychophysiology	psychology
dracaena	agave
neurosyphilis	syphilis
pederasty	homosexuality
gofer	employee
rectangle	parallelogram
pharmacogenetics	genetics
macrophage	phagocyte
trembler	coward
haycock	haystack
popularizer	communicator
nasality	timbre
parsons	clergyman
meperidine	narcotic
methadone	narcotic
primatology	mammalogy
physicist	scientist
palaeontologist	scientist
latke	pancake
proteome	protein
conceptus	animal
agriculturalist	farmer
customer	consumer
vibrio	eubacteria
willpower	resoluteness
quinine	antimalarial
potentiation	synergy
ceftriaxone	cephalosporin
suffragette	suffragist
breadwinner	earner
lakota	sioux
falchion	sword
dioxin	hydrocarbon
timorese	asian
pallbearer	mourner
echinococcus	tapeworm
warthog	swine
storehouse	depository
textile	artifact
unbox	unpack
blain	sore
clairvoyant	psychic
erotic	sensualist
freethinking	doctrine
demeaning	humiliate
dramamine	antihistamine
angiotensin	vasoconstrictor
unawareness	unconsciousness
cfc	fluorocarbon
laetrile	amygdalin
antipasto	appetizer
aristotelian	disciple
gout	arthritis
acetyl	acyl
entrepreneur	businessperson
mack	raincoat
eosin	fluorescein
adrenaline	vasoconstrictor
spokeswoman	spokesperson
rectitude	righteousness
messiah	savior
pinkie	minimus
midshipman	cadet
lymphocyte	leukocyte
rimu	conifer
shyster	wrongdoer
epicure	sensualist
marabout	stork
panty	underpants
hymie	jew
directive	pronouncement
oligosaccharide	carbohydrate
artemisia	shrub
ventolin	bronchodilator
hirsutism	hairiness
idolized	adore
leptospirosis	zoonosis
thankfulness	gratitude
