grape	fruit
opera	song
mouse	rodent
pet	dog
ballpoint	pen
chihuahua	dog
shirt	clothing
wheat	bread
spear	weapon
robin	bird
carrot	vegetable
mustang	car
carabao	animal
senator	politician
van	automobile
brown	hair
refrigerator	appliance
ant	insect
rain	weather
astilbe	bush
swan	bird
dog	pet
azalea	bush
boot	footwear
pig	animal
tree	oak
ring	jewelry
furniture	couch
abstract	art
knit	sweater
poodle	dog
dollar	currency
porpoise	mammal
currency	dollar
couch	furniture
ash	tree
university	school
oak	tree
bread	wheat
red	color
chair	furniture
clarinet	instrument
gasoline	fuel
stool	seat
chair	seat
oil	lubricant
tree	home
apple	fruit
appliance	fridge
sock	clothing
girl	person
chisel	tool
plate	dish
apple	food
food	apple
clothing	sock
person	girl
furniture	chair
pot	vessel
tool	chisel
salt	preservative
sculpture	artwork
ham	meat
violin	instrument
pepper	seasoning
hammer	tool
chair	furniture
shirt	clothing
bus	transportation
utensil	fork
sandal	shoe
fridge	appliance
dog	animal
screwdriver	tool
comedy	movie
skirt	garment
spoon	utensil
water	beverage
banana	nourishment
animal	cat
spinach	vegetable
shirt	garment
