shirts	clothes
sculpture	art
makeup	eyeshadow
pennies	coins
couch	seat
salmon	fish
cardinal	bird
bowl	dish
stamps	hobby
animals	dogs
blouses	clothes
collies	dogs
flower	daisy
piano	instrument
sodas	beverages
phone	cordless
rings	jewelry
dogs	pets
forks	cutlery
apples	fruit
raccoon	animal
dresses	clothing
website	internet
water	beverage
boot	shoe
chair	furniture
apple	fruit
plates	china
librarian	worker
dime	money
basil	herb
cats	animals
drama	film
dahlias	flowers
mica	mineral
chips	snacks
crows	birds
family	father
cashews	nuts
flute	instrument
cows	animals
cars	fords
chairs	furniture
tea	beverages
beef	meat
sedan	cars
dollar	currency
hammer	tool
fords	cars
laptop	computer
